You wake up to the ringing of your alarm. Images of a strange dream drift through your mind, but when you try to conjure them, you draw a blank.

(´｡• ᵕ •｡`) ♡ 
Dreamland
An Interactive Fiction by mellyeliu
Release 1 / Serial number 250209 / Inform 7 v10.1.2 / D

Bedroom
 .   \_/       .:"    .:"    .:"
 -=(_)=- /\ ||    /\||    /\||
 .   / \     //\\|   //\\|   //\\|
 .          //  \\  //  \\  //  \\
 .         //    \ ^/    \^/    \\
 .         |  ( )  ||  ( ) || ( ) |
 .         |       ||      ||      |%
 &%&--==--&%-==--%&

Your bedroom is unadorned. The walls are chalky and the ground bare. The only decoration is a poster of The Killers. A lightbulb hangs from the ceiling. A tiny window is opened a crack, and the sound of faint static comes through. A crumpled newsprint lies in the wastebin, forgotten.

In the corner your monitor blinks wearily. You must've forgotten to turn it off.  Beside you is a worn out drawer. To the north your kitchen fridge hums. To the south is a cramped closet. 

Type help or about to get started.

>X
What do you want to examine?

* * *

>ask emma to get up
You can't see any such thing.

>say hi to emma
You can't see any such thing.

>ask emma about to get up
You can't see any such thing.

>e
You can't go that way.

>s
Kitchen
Your kitchen has seen better days. A fridge lies in one corner. Near the door is a row of plants with yellowing leaves. At the north corner is a door that leads onto the street.

You can see a jug, a plant, a note and a fridge (closed) here.

>a
That's not a verb I recognise.

>w
You can't go that way.

>n
Bedroom
 .   \_/       .:"    .:"    .:"
 -=(_)=- /\ ||    /\||    /\||
 .   / \     //\\|   //\\|   //\\|
 .          //  \\  //  \\  //  \\
 .         //    \ ^/    \^/    \\
 .         |  ( )  ||  ( ) || ( ) |
 .         |       ||      ||      |%
 &%&--==--&%-==--%&

Your bedroom is unadorned. The walls are chalky and the ground bare. The only decoration is a poster of The Killers. A lightbulb hangs from the ceiling. A tiny window is opened a crack, and the sound of faint static comes through..

In the corner your monitor blinks wearily. You must've forgotten to turn it off.  Beside you is a worn out drawer. To the south your kitchen fridge hums. To the north is a cramped closet.

>leave emma
I only understood you as far as wanting to leave.

>w
You can't go that way.

>open fridge
You can't see any such thing.

>eat candy
You can't see any such thing.

>eat candy
You can't see any such thing.

>e
You can't go that way.

>open drawer
It seems to be locked.

>unlock drawer with key
You can't see any such thing.

>open drawer
It seems to be locked.

>take all
There are none at all available!

>read journal
You can't see any such thing.

>ask emma
You can't see any such thing.

>ask emma about hi
You can't see any such thing.

* * *

>draw
What do you want to draw on?

>draw
What do you want to draw on?

>open nightstand
You can't see any such thing.

>take all
There are none at all available!

>draw bunny on book
I didn't understand that sentence.

>x book
You can't see any such thing.

>draw bunny on newsprint
I didn't understand that sentence.

>x newsprint
You straighten out the sheet of newspaper, handling it delicately. You can't quite make out the words. Your head is spinning.

>i
You are carrying nothing.

>draw sdf on newsprint
I didn't understand that sentence.

>x crayons
You can't see any such thing.

I beg your pardon?

>draw bunny on newsprint
I didn't understand that sentence.

* * *

>i
You are carrying nothing.

>i
You are carrying nothing.

>draw bunny on book
I didn't understand that sentence.

>draw narwhal on book
I didn't understand that sentence.

>draw narwhal on newsprint
I didn't understand that sentence.

* * *

>draw narwhal on newsprint
I didn't understand that sentence.

>draw lion on newsprint
I didn't understand that sentence.

>draw bunny on newsprint
I didn't understand that sentence.

>i
You are carrying nothing.

>take all
There are none at all available!

>take all
There are none at all available!

>i
You are carrying nothing.

>draw lion on newsprint
I didn't understand that sentence.

>i
You are carrying nothing.

>draw lion on book
I didn't understand that sentence.

>open nightstand
You can't see any such thing.

* * *

>take all
There are none at all available!

>draw lion on book
I didn't understand that sentence.

>take all
There are none at all available!

* * *

>e
You can't go that way.

>n
Closet
The closet is small and cramped, with a single cardboard box in the corner. It's dimly lit, and you can smell a faint musty odor, as if the space hasn't been opened in years. The walls are lined with old, forgotten coats, and the ceiling is low, making the space feel claustrophobic.

You can see a suitcase (closed) here.

>s
Bedroom
 .   \_/       .:"    .:"    .:"
 -=(_)=- /\ ||    /\||    /\||
 .   / \     //\\|   //\\|   //\\|
 .          //  \\  //  \\  //  \\
 .         //    \ ^/    \^/    \\
 .         |  ( )  ||  ( ) || ( ) |
 .         |       ||      ||      |%
 &%&--==--&%-==--%&

Your bedroom is unadorned. The walls are chalky and the ground bare. The only decoration is a poster of The Killers. A lightbulb hangs from the ceiling. A tiny window is opened a crack, and the sound of faint static comes through..

In the corner your monitor blinks wearily. You must've forgotten to turn it off.  Beside you is a worn out drawer. To the south your kitchen fridge hums. To the north is a cramped closet.

>w
You can't go that way.

>leave emma
I only understood you as far as wanting to leave.

* * *

>e
You can't go that way.

>w
You can't go that way.

* * *

>open fridge
You can't see any such thing.

>eat apple
You can't see any such thing.

>e
You can't go that way.

>unlock book with key
You can't see any such thing.

>open book
You can't see any such thing.

>yes
That was a rhetorical question.

>no
That was a rhetorical question.

>yes
That was a rhetorical question.

>yes
That was a rhetorical question.

>.
That's not a verb I recognise.

>.
That's not a verb I recognise.

>no
That was a rhetorical question.

>nin'
That's not a verb I recognise.

* * *

>turn on computer
The monitor lights up with a staticky pop. 
You switch the computer on.

* * *

>go north
Closet
The closet is small and cramped, with a single cardboard box in the corner. It's dimly lit, and you can smell a faint musty odor, as if the space hasn't been opened in years. The walls are lined with old, forgotten coats, and the ceiling is low, making the space feel claustrophobic.

You can see a suitcase (closed) here.

>go to kitchen
Kitchen
Your kitchen has seen better days. A fridge lies in one corner. Near the door is a row of plants with yellowing leaves. At the north corner is a door that leads onto the street.

You can see a jug, a plant, a note and a fridge (closed) here.

>x note
There's a note stuck to the fridge. It reads  ??? ??? ????????? ???? You can't make out the text ."

>open fridge
The fridge contains a jug and a piece of candy. The candy beckons to you.

>eat candy
(first taking the candy)
You pocket the candy. It feels heavy, like nostalgia.

You unwrap the candy and pop it in your mouth. It tastes of a strange medley of flavours - vanilla custard, citrus, a hint of buttered toast. Delightful.

A sudden prickling rips through your throat, like you've swallowed something you shouldn't have. You double over, coughing, clutching the counter for balance. There's something lodged in your throat.

Clang! Out comes a small piece of metal. You pick it up, bewildered. It's a small key.

>i
You are carrying:
  a silver key

>go to door
That noun did not make sense in this context.

>go to the door
That noun did not make sense in this context.

>open door
You can't see any such thing.

>x note
There's a note stuck to the fridge. It reads  "Where did you go? Come play with me in Dreamland /( ^^)/."

>open fridge
That's already open.

>look at fridge
You're bizarrely attached to your fridge. It's charming in its age, rickedy, humming in a contented manner. It's covered with  and a note is pinned to it.

I beg your pardon?

I beg your pardon?

>drink the potion
You can't see any such thing.

>open potion
You can't see any such thing.

>open black vial
You can't see any such thing.

>drink black vial
You can't see any such thing.

>take black vial
You can't see any such thing.

>take all
jug: Taken. You see nothing special about the jug.

>i
You are carrying:
  a jug
  a silver key

>go to bedroom
Bedroom
 .   \_/       .:"    .:"    .:"
 -=(_)=- /\ ||    /\||    /\||
 .   / \     //\\|   //\\|   //\\|
 .          //  \\  //  \\  //  \\
 .         //    \ ^/    \^/    \\
 .         |  ( )  ||  ( ) || ( ) |
 .         |       ||      ||      |%
 &%&--==--&%-==--%&

You step into the bedroom and are flooded with emotion. Every inch of its surface now looks as if it's been dipped in. The walls are pulsating and warm, shifting from blue to red to violet. .

Lo-fi indie is playing from your computer. You notice movement on the screen. Beside you is a worn out drawer. To the south your kitchen fridge hums. To the north is a cramped closet.

>go to closet
Closet
The closet is small and cramped, with a single cardboard box in the corner. It's dimly lit, and you can smell a faint musty odor, as if the space hasn't been opened in years. The walls are lined with old, forgotten coats, and the ceiling is low, making the space feel claustrophobic.

You can see a suitcase (closed) here.

>x closet
You can't see any such thing.

>x box
You can't see any such thing.

>x drawer
You can't see any such thing.

>open box
You can't see any such thing.

>open yearbook
You can't see any such thing.

>x record player
You can't see any such thing.

>turn on record player
You can't see any such thing.

* * *

>go to kitchen
Kitchen
Your kitchen has seen better days. A fridge lies in one corner. Near the door is a row of plants with yellowing leaves. At the north corner is a door that leads onto the street.

You can see a jug, a plant, a note and a fridge (closed) here.

>go to plant
That noun did not make sense in this context.

* * *

>go left
That noun did not make sense in this context.

>x closet
You can't see any such thing.

* * *

>go north
Closet
The closet is small and cramped, with a single cardboard box in the corner. It's dimly lit, and you can smell a faint musty odor, as if the space hasn't been opened in years. The walls are lined with old, forgotten coats, and the ceiling is low, making the space feel claustrophobic.

You can see a suitcase (closed) here.

>go south
Bedroom
 .   \_/       .:"    .:"    .:"
 -=(_)=- /\ ||    /\||    /\||
 .   / \     //\\|   //\\|   //\\|
 .          //  \\  //  \\  //  \\
 .         //    \ ^/    \^/    \\
 .         |  ( )  ||  ( ) || ( ) |
 .         |       ||      ||      |%
 &%&--==--&%-==--%&

Your bedroom is unadorned. The walls are chalky and the ground bare. The only decoration is a poster of The Killers. A lightbulb hangs from the ceiling. A tiny window is opened a crack, and the sound of faint static comes through..

In the corner your monitor blinks wearily. You must've forgotten to turn it off.  Beside you is a worn out drawer. To the south your kitchen fridge hums. To the north is a cramped closet.

>go to closet
Closet
The closet is small and cramped, with a single cardboard box in the corner. It's dimly lit, and you can smell a faint musty odor, as if the space hasn't been opened in years. The walls are lined with old, forgotten coats, and the ceiling is low, making the space feel claustrophobic.

You can see a suitcase (closed) here.

>go to bedroom
Bedroom
 .   \_/       .:"    .:"    .:"
 -=(_)=- /\ ||    /\||    /\||
 .   / \     //\\|   //\\|   //\\|
 .          //  \\  //  \\  //  \\
 .         //    \ ^/    \^/    \\
 .         |  ( )  ||  ( ) || ( ) |
 .         |       ||      ||      |%
 &%&--==--&%-==--%&

Your bedroom is unadorned. The walls are chalky and the ground bare. The only decoration is a poster of The Killers. A lightbulb hangs from the ceiling. A tiny window is opened a crack, and the sound of faint static comes through..

In the corner your monitor blinks wearily. You must've forgotten to turn it off.  Beside you is a worn out drawer. To the south your kitchen fridge hums. To the north is a cramped closet.

>x closet
You can't see any such thing.

* * *

>go to Kitchen
You can't see any such thing.

>w
Kitchen
Your kitchen has seen better days. A fridge lies in one corner.

The old fridge hums irratically. Your stomach growls.

Ruby smiles at you.

>x fridge
There's a note stuck to the fridge. It reads   ¯¯̿̿¯̿̿"̿̿̿̿̿̿̿"̿̿"̿̿̿̿̿"̿̿̿)͇̿̿)̿̿̿̿ "̿̿̿̿̿̿\̵͇̿̿\=(•̪̀●́)=o/̵͇̿̿/"̿̿ ̿ ̿̿ ."

>open fridge
You open the fridge, revealing an apple.

>eat apple
(first taking the apple)
You're dizzy.

>x fridge
There's a note stuck to the fridge. It reads   "Return USB to Fred. Fred is happy."

You're dizzy.

* * *

>go to closet
Closet
The closet is small and cramped, with a single cardboard box in the corner. It's dimly lit, and you can smell a faint musty odor, as if the space hasn't been opened in years. The walls are lined with old, forgotten coats, and the ceiling is low, making the space feel claustrophobic.

You can see a suitcase (closed) here.

>open suitcase
> This suitcase requires a passcode:

I beg your pardon?

> This suitcase requires a passcode:

>1234
That's not a verb I recognise.

> This suitcase requires a passcode:

>1234
That's not a verb I recognise.

> This suitcase requires a passcode:

* * *

>open suitcase
> This suitcase requires a passcode:

>1234
The suitcase clicks open as the passcode is accepted.

>x suitcase
 Inside the suitcase is a collection of random objects, a yearbook, a record player, and a narwhal

In the suitcase are a yearbook, record player and narwhal.

>close suitcase
You close the suitcase.

* * *

>x suitcase
 Inside the suitcase is a collection of random objects, a yearbook, a record player, and a narwhal

In the suitcase are a yearbook, record player and narwhal.

>open suitcase
> This suitcase requires a passcode:

>1234
That's not a verb I recognise.

* * *

>open suitcase
> This suitcase requires a passcode:

>rewe
The suitcase beeps. The passcode is incorrect.

>x suitcase
 A small black suitcase with a tag that reads "My favourite ice cream" and a keypad on the side. It looks like it requires a passcode to open.

>open suitcase
> This suitcase requires a passcode:

* * *

>go to drawer
That noun did not make sense in this context.

>open drawe
You can't see any such thing.

>open drawer
It seems to be locked.

>go to close
That noun did not make sense in this context.

>go to closet
Closet
It's empty except for a single cardbord box. You feel cramped.

You can see a cardboard box (closed) here.

>open box
Inside is a yearbook, a record player, a binder, and a 3D printed narwhal, amongst other odds and ends.
The closet smells dusty.

>open yearbook
That's already open.

>x yearbook
 ??? ???? ???? ???? You can't make out the text right now..

>x record player
A vintage turntable. It's loaded with a vinyl - Best of 2010s Hits.

Record player is currently switched off.

>turn on record player
You switch record player on.

Phoebe Bridgers fills the room.

* * *

>go to kitcehn
That noun did not make sense in this context.

>go to kitchen
Kitchen
Your kitchen has seen better days. A fridge lies in one corner. Near the door is a row of plants with yellowing leaves. At the north corner is a door that leads onto the street.

You can see a jug, a plant, a note and a fridge (closed) here.

>open fridge
The fridge contains a jug and a piece of candy. The candy beckons to you.

* * *

>i
You are carrying:
  a silver key

>go to bedroom
Bedroom
 .   \_/       .:"    .:"    .:"
 -=(_)=- /\ ||    /\||    /\||
 .   / \     //\\|   //\\|   //\\|
 .          //  \\  //  \\  //  \\
 .         //    \ ^/    \^/    \\
 .         |  ( )  ||  ( ) || ( ) |
 .         |       ||      ||      |%
 &%&--==--&%-==--%&

You step into the bedroom and are flooded with emotion. Every inch of its surface now looks as if it's been dipped in. The walls are pulsating and warm, shifting from blue to red to violet.  To the south your kitchen fridge hums.

Lo-fi indie is playing from your computer. You notice movement on the screen. Beside you is a worn out drawer. To the north is a cramped closet.

>unlock drawe
You can't see any such thing.

>unlock drawer
(with the silver key)
You unlock the drawer.

>open drawer
You pull open the drawer. A journal, a box of crayons, and a pair of glasses  lies inside. The journal beckons to you.

>take all
journal: Taken. A worn out journal in which you've taken to scrawling your dreams.

TABLE OF CONTENTS:
 1  TOYBOX
 2  ??????????
 3  ??????????

crayons: Taken. A bright yellow box. On it are instructions on how to draw certain shapes: a bunny, a lion, a narwhal, and a unicorn.

glasses: Taken. A wacky looking pair of with black frames and blue-purple swirling lenses. On the side are the words  Sentence Scrambler.

>read page 2 of journal
A thunderous crack cuts through the air. Everything begins to spin. You watch as everything around you dissolves and reforms until your eyes begin to burn from the distortion. 2. "PLUSHIELAND"

Plushieland
You wake up in world of cotton. Everything you see is rendered in a shade of pastel - the turgid river, the sky, the meadows in front of you. A girl around the age of seven is digging up flowers.

>x journal
A worn out journal in which you've taken to scrawling your dreams.

TABLE OF CONTENTS:
 1  TOYBOX
 2  ??????????
 3  ??????????

* * *

>go to kitchen
Kitchen
Your kitchen has seen better days. A fridge lies in one corner. Near the door is a row of plants with yellowing leaves. At the north corner is a door that leads onto the street.

You can see a jug, a plant, a note and a fridge (closed) here.

>gfdfg
That's not a verb I recognise.

>go to Kitchen
That noun did not make sense in this context.

>x Kitchen
You can't see any such thing.

>go Kitchen
Kitchen
Your kitchen has seen better days. A fridge lies in one corner. At the north corner is a door that leads onto the street.

The old fridge hums irratically. Your stomach growls.

>go west
You can't go that way.

>go to kitchen
That noun did not make sense in this context.

>go west
You can't go that way.

>w
You can't go that way.

>w
You can't go that way.

>e
Bedroom
Your bedroom is unadorned. The walls are the colour of chalk and the ground is bare. The sole decor in the room is a music poster of The Killers, and the edges are freyed. A collection of empty plastic water bottles are scattered across the floor. A single lightbulb hangs from the ceiling. A tiny window is opened a crack, and a faint breeze comes through.

Beside you is a worn out nightstand. It's covered with a thick layer of dust and lined with faint scratches.

Over in the corner your computer monitor blinks wearily. Last night's League of Legends match history stares you right in the face. You must've forgotten to turn it off.

An flyer lies wrinkled on the floor.

>go est
That noun did not make sense in this context.

>go north
You can't go that way.

>go south
You can't go that way.

>go west
Kitchen
Your kitchen has seen better days. A fridge lies in one corner. At the north corner is a door that leads onto the street.

The old fridge hums irratically. Your stomach growls.

>go dreamland
Which do you mean, Dreamland or Dreamland 2?

>go Dreamland
Which do you mean, Dreamland or Dreamland 2?

>go to kitchen
That noun did not make sense in this context.

>go to House
That noun did not make sense in this context.

>go kitchen
Kitchen
Your kitchen has seen better days. A fridge lies in one corner. At the north corner is a door that leads onto the street.

The old fridge hums irratically. Your stomach growls.

* * *

>go to kitchen
Kitchen
Your kitchen has seen better days. A fridge lies in one corner. Near the door is a row of plants with yellowing leaves. At the north corner is a door that leads onto the street.

You can see a jug, a plant, a note and a fridge (closed) here.

>go kitchen
You can't see any such thing.

>l
Bedroom
Your bedroom is unadorned. Nearby your kitchen light remains on.

Over in the corner your computer monitor blinks wearily. You must've forgotten to turn it off.

An flyer lies wrinkled on the floor.

>ruby
That's not a verb I recognise.

>e
You can't go that way.

>w
Kitchen
Your kitchen has seen better days. A fridge lies in one corner.

The old fridge hums irratically.

Ruby smiles at you.

>l
Kitchen
Your kitchen has seen better days. A fridge lies in one corner.

The old fridge hums irratically.

Ruby smiles at you.

>sleep with ruby
I only understood you as far as wanting to sleep.

>fuck ruby
That's not a verb I recognise.

>kiss ruby
Ruby might not like that.

>kiss ruby
Ruby might not like that.

>kill ruby
Violence isn't the answer to this one.

>feel ruby
Ruby might not like that.

>touch ruby
Ruby might not like that.

>clear
What do you want to clear?

>say hi to ruby
There is no reply.

* * *

>eat candy
(first taking the candy)
You pocket the candy. It feels heavy, like nostalgia.

You unwrap the candy and pop it in your mouth. It tastes of a strange medley of flavours - vanilla custard, citrus, a hint of buttered toast. Delightful.

A sudden prickling rips through your throat, like you've swallowed something you shouldn't have. You double over, coughing, clutching the counter for balance. There's something lodged in your throat.

Clang! Out comes a small piece of metal. You pick it up, bewildered. It's a small key.

>go to bedroom
Bedroom
 .   \_/       .:"    .:"    .:"
 -=(_)=- /\ ||    /\||    /\||
 .   / \     //\\|   //\\|   //\\|
 .          //  \\  //  \\  //  \\
 .         //    \ ^/    \^/    \\
 .         |  ( )  ||  ( ) || ( ) |
 .         |       ||      ||      |%
 &%&--==--&%-==--%&

You step into the bedroom and are flooded with emotion. Every inch of its surface now looks as if it's been dipped in. The walls are pulsating and warm, shifting from blue to red to violet. .

Lo-fi indie is playing from your computer. You notice movement on the screen. Beside you is a worn out drawer. To the south your kitchen fridge hums. To the north is a cramped closet.

>unlock drawer
(with the silver key)
You unlock the drawer.

* * *

>take all
journal: Taken. A worn out journal in which you've taken to scrawling your dreams.

TABLE OF CONTENTS:
 1  TOYBOX
 2  ??????????
 3  ??????????

crayons: Taken. A bright yellow box. On it are instructions on how to draw certain shapes: a bunny, a lion, a narwhal, and a unicorn.

glasses: Taken. A wacky looking pair of with black frames and blue-purple swirling lenses. On the side are the words  Sentence Scrambler.

>read journal
You flip the pages randomly and arrive at page 1:

A thunderous crack cuts through the air. Everything begins to spin. You watch as everything around you dissolves and reforms until your eyes begin to burn from the distortion. 1. "TOYBOX"

Toybox (Dreamland)
 |                  /\   
 |                 / | \ 
 |                / | | \ 
 |               /_|_|_|_
 |                |     / /
 |__    __    __ |    / /__    __    __
 |  |__|  |__|  |.   / /|  |__|  |__|  |
 |__            ____/ /___           __|
 |          / .------  )         |
 |         / /        /          |  TOYBOX
 |        / /        /           |
 ~~~~~~~~~~~~-----------~~~~~~~~

You open your eyes to pure whiteness. Every bit of empty space is blue lines, pink margins...

Margins! That's it. The world you're in is rendered on notebook paper. Objects are flat, paperlike, outlined in waxy lines. You look down at your hands and suppress a cry of shock. You're wearing a triangular smock of purple and your body is composed of black lines. You unfurl your fingers and watch as the lines retract and relax.

You take in the rest of your surroundings. You seem to be in a playground of sorts. There's a set of swings and a playstructure in a garish primary colours. In the distance is a forest, the paper trees swaying in the wind.

A girl no older than five is playing in the field. She's crawling through the grass, plucking out a stem here and there.

>go to kitchen
Kitchen
Your kitchen has seen better days. A fridge lies in one corner. Near the door is a row of plants with yellowing leaves. At the north corner is a door that leads onto the street.

You can see a jug, a plant, a note and a fridge (empty) here.

>go to bedroom
Bedroom
 .   \_/       .:"    .:"    .:"
 -=(_)=- /\ ||    /\||    /\||
 .   / \     //\\|   //\\|   //\\|
 .          //  \\  //  \\  //  \\
 .         //    \ ^/    \^/    \\
 .         |  ( )  ||  ( ) || ( ) |
 .         |       ||      ||      |%
 &%&--==--&%-==--%&

You step into the bedroom and are flooded with emotion. Every inch of its surface now looks as if it's been dipped in. The walls are pulsating and warm, shifting from blue to red to violet.  To the south your kitchen fridge hums.

Lo-fi indie is playing from your computer. You notice movement on the screen. Beside you is a worn out drawer. To the north is a cramped closet.

>read page 1
What do you want to read page that in?

>read page 1 of journal
A thunderous crack cuts through the air. Everything begins to spin. You watch as everything around you dissolves and reforms until your eyes begin to burn from the distortion. 1. "TOYBOX"

Toybox (Dreamland)
 |                  /\   
 |                 / | \ 
 |                / | | \ 
 |               /_|_|_|_
 |                |     / /
 |__    __    __ |    / /__    __    __
 |  |__|  |__|  |.   / /|  |__|  |__|  |
 |__            ____/ /___           __|
 |          / .------  )         |
 |         / /        /          |  TOYBOX
 |        / /        /           |
 ~~~~~~~~~~~~-----------~~~~~~~~

You open your eyes to pure whiteness. Every bit of empty space is blue lines, pink margins...

Margins! That's it. The world you're in is rendered on notebook paper. Objects are flat, paperlike, outlined in waxy lines. You look down at your hands and suppress a cry of shock. You're wearing a triangular smock of purple and your body is composed of black lines. You unfurl your fingers and watch as the lines retract and relax.

You take in the rest of your surroundings. You seem to be in a playground of sorts. There's a set of swings and a playstructure in a garish primary colours. In the distance is a forest, the paper trees swaying in the wind.

A girl no older than five is playing in the field. She's crawling through the grass, plucking out a stem here and there.

* * *

>take all
journal: Taken. A worn out journal in which you've taken to scrawling your dreams.

TABLE OF CONTENTS:
 1  TOYBOX
 2  ??????????
 3  ??????????

crayons: Taken. A bright yellow box. On it are instructions on how to draw certain shapes: a bunny, a lion, a narwhal, and a unicorn.

glasses: Taken. A wacky looking pair of with black frames and blue-purple swirling lenses. On the side are the words  Sentence Scrambler.

>read page 1 of journal
A thunderous crack cuts through the air. Everything begins to spin. You watch as everything around you dissolves and reforms until your eyes begin to burn from the distortion. 1. "TOYBOX"

Toybox (Dreamland)
 |                  /\   
 |                 / | \ 
 |                / | | \ 
 |               /_|_|_|_
 |                |     / /
 |__    __    __ |    / /__    __    __
 |  |__|  |__|  |.   / /|  |__|  |__|  |
 |__            ____/ /___           __|
 |          / .------  )         |
 |         / /        /          |  TOYBOX
 |        / /        /           |
 ~~~~~~~~~~~~-----------~~~~~~~~

You open your eyes to pure whiteness. Every bit of empty space is blue lines, pink margins...

Margins! That's it. The world you're in is rendered on notebook paper. Objects are flat, paperlike, outlined in waxy lines. You look down at your hands and suppress a cry of shock. You're wearing a triangular smock of purple and your body is composed of black lines. You unfurl your fingers and watch as the lines retract and relax.

You take in the rest of your surroundings. You seem to be in a playground of sorts. There's a set of swings and a playstructure in a garish primary colours. In the distance is a forest, the paper trees swaying in the wind. One of the trees stands proudly in the center, a broken ladder propped against it.

A girl no older than five is playing in the field. She's crawling through the grass, plucking out a stem here and there.

>draw on ladder with crayons
You use the crayon to draw in the missing rungs on the ladder. It now seems sturdy and ready to climb.

>climb ladder
You climb the ladder.

Treehouse
You have entered a cozy treehouse. It has a wooden floor, a small table with some board games, a hammock, and a girl named Emma who is sitting on a bean bag chair. There's a window with a view of the forest below.

You can see Emma here.

>draw dandelion with crayons
You use the crayons to carefully draw a bright yellow dandelion. The petals are vivid, and the stem is a bright green. The drawing looks almost alive.

The air sizzles, and with a pop, something drops in your pocket

>give dandelion to emma
Emma looks up at you in wonder. "A dandelion", she whispers reverentially. "I've never seen one before."

You tell her they're commonplace where you're from. "That can't be right," she says. "My grandma says they went extinct long ago. They were killed, you know. For being too resilient. She cups the fluffy white thing delicately. "C'mon! Let's wish together."

You put your heads together and your breaths create a flurry of white as the spores release into the air. You stare at this strange girl, wide-eyed with awe, twirling the empty stem in her hands. You're drawn to her uncomplicated joy.

"I wished for a friend," she says abruptly. She gazes at you in wonder. "I've never had a friend. Will you be my friend?

> Befriend Emma? Y/N

>y
Her face blooms with delight. "YAAAAY", she cries. "We can all be friends now. Me, you, Mr. Narkins.

Her face darkens for a second. "Have you seen him, by the way? He's a sea unicorn." You feel suction around you, like you're going through a vacuum. Everything blurs.

Bedroom
 .   \_/       .:"    .:"    .:"
 -=(_)=- /\ ||    /\||    /\||
 .   / \     //\\|   //\\|   //\\|
 .          //  \\  //  \\  //  \\
 .         //    \ ^/    \^/    \\
 .         |  ( )  ||  ( ) || ( ) |
 .         |       ||      ||      |%
 &%&--==--&%-==--%&

 It's weird to see things in 3D now. Your room has gone back to normal. There's an odd humming coming from your computer, though. .

 Beside you is a worn out drawer. To the south your kitchen fridge hums. To the north is a cramped closet. 

That was a rhetorical question.

>x computer
The browser is open to your email inbox. You have 5 unread emails. You can select an email to read by typing a number from 1 to 5 or type `exit` to leave.

> Select an email to read:

>switch computer on
Invalid selection. Please select an email to read by typing a number from 1 to 5
> Select an email to read:

>3
From: Emma - Ideas for Our Universe

Hey, I had some ideas for the fictional world we're creating together! We should have flying narwhals, secret caves, and magical powers that only the bravest can use! Let me know what you think.
That's not a verb I recognise.

> Select an email to read:

>3
From: Emma - Ideas for Our Universe

Hey, I had some ideas for the fictional world we're creating together! We should have flying narwhals, secret caves, and magical powers that only the bravest can use! Let me know what you think.
That's not a verb I recognise.

> Select an email to read:

>4
From: School Admin - Field Trip to the Science Museum

Parents and Guardians, We are planning a field trip to the Science Museum next month. Please submit the signed permission slip by Friday.
That's not a verb I recognise.

> Select an email to read:

* * *

>switch computer on
Invalid selection. Please select an email to read by typing a number from 1 to 5
> Select an email to read:

>After reading a command when the command prompt is "> Select an email to read: ":
Invalid selection. Please select an email to read by typing a number from 1 to 5
> Select an email to read:

>if the player's command matches "1":
Invalid selection. Please select an email to read by typing a number from 1 to 5
> Select an email to read:

>say "From: Emma - Word Search from Emma[paragraph break]Hi! I made you a word search. Try to find the words Jubjub, Poogle, and Kacheek! It’ll be fun. (Hint: look horizontally, vertically, and diagonally.)";
Invalid selection. Please select an email to read by typing a number from 1 to 5
> Select an email to read:

>reject the player's command.
Invalid selection. Please select an email to read by typing a number from 1 to 5
> Select an email to read:

>else if the player's command matches "2":
Invalid selection. Please select an email to read by typing a number from 1 to 5
> Select an email to read:

>say "From: Mr. Anderson - Welcome to 5th Grade![paragraph break]Dear Student, Welcome to 5th grade! We are excited to have you. Make sure to bring your materials on the first day. Your new teacher, Mr. Anderson.";
Invalid selection. Please select an email to read by typing a number from 1 to 5
> Select an email to read:

>reject the player's command.
Invalid selection. Please select an email to read by typing a number from 1 to 5
> Select an email to read:

>else if the player's command matches "3":
Invalid selection. Please select an email to read by typing a number from 1 to 5
> Select an email to read:

>say "From: Emma - Ideas for Our Universe[paragraph break]Hey, I had some ideas for the fictional world we're creating together! We should have flying narwhals, secret caves, and magical powers that only the bravest can use! Let me know what you think.";
Invalid selection. Please select an email to read by typing a number from 1 to 5
> Select an email to read:

>reject the player's command.
Invalid selection. Please select an email to read by typing a number from 1 to 5
> Select an email to read:

>else if the player's command matches "4":
Invalid selection. Please select an email to read by typing a number from 1 to 5
> Select an email to read:

>say "From: School Admin - Field Trip to the Science Museum[paragraph break]Parents and Guardians, We are planning a field trip to the Science Museum next month. Please submit the signed permission slip by Friday.";
Invalid selection. Please select an email to read by typing a number from 1 to 5
> Select an email to read:

>reject the player's command.
Invalid selection. Please select an email to read by typing a number from 1 to 5
> Select an email to read:

>else if the player's command matches "5":
Invalid selection. Please select an email to read by typing a number from 1 to 5
> Select an email to read:

>say "From: Art Class Reminder - Reminder: Bring Your Crayons to Art Class![paragraph break]This is a reminder to bring your crayons to art class next week. We’ll be doing a special drawing activity.";
Invalid selection. Please select an email to read by typing a number from 1 to 5
> Select an email to read:

>reject the player's command.
Invalid selection. Please select an email to read by typing a number from 1 to 5
> Select an email to read:

>else if the player's command matches "exit":
Invalid selection. Please select an email to read by typing a number from 1 to 5
> Select an email to read:

>reject the player's command;
Invalid selection. Please select an email to read by typing a number from 1 to 5
> Select an email to read:

>now the command prompt is ">".
Invalid selection. Please select an email to read by typing a number from 1 to 5
> Select an email to read:

>else:
Invalid selection. Please select an email to read by typing a number from 1 to 5
> Select an email to read:

>say "Invalid selection. Please select an email to read by typing a number from 1 to 5.";
Invalid selection. Please select an email to read by typing a number from 1 to 5
> Select an email to read:

>reject the player's command.
Invalid selection. Please select an email to read by typing a number from 1 to 5
> Select an email to read:

>3
From: Emma - Ideas for Our Universe

Hey, I had some ideas for the fictional world we're creating together! We should have flying narwhals, secret caves, and magical powers that only the bravest can use! Let me know what you think.

> Select an email to read:

>3
From: Emma - Ideas for Our Universe

Hey, I had some ideas for the fictional world we're creating together! We should have flying narwhals, secret caves, and magical powers that only the bravest can use! Let me know what you think.

> Select an email to read:

>4
From: School Admin - Field Trip to the Science Museum

Parents and Guardians, We are planning a field trip to the Science Museum next month. Please submit the signed permission slip by Friday.

> Select an email to read:

>2
From: Mr. Anderson - Welcome to 5th Grade!

Dear Student, Welcome to 5th grade! We are excited to have you. Make sure to bring your materials on the first day. Your new teacher, Mr. Anderson.

> Select an email to read:

>3
From: Emma - Ideas for Our Universe

Hey, I had some ideas for the fictional world we're creating together! We should have flying narwhals, secret caves, and magical powers that only the bravest can use! Let me know what you think.

> Select an email to read:

>1
From: Art Class Reminder - Reminder: Bring Your Crayons to Art Class!

This is a reminder to bring your crayons to art class next week. We'll be doing a special drawing activity.

> Select an email to read:

>2
From: Mr. Anderson - Welcome to 5th Grade!

Dear Student, Welcome to 5th grade! We are excited to have you. Make sure to bring your materials on the first day. Your new teacher, Mr. Anderson.

> Select an email to read:

>4
From: School Admin - Field Trip to the Science Museum

Parents and Guardians, We are planning a field trip to the Science Museum next month. Please submit the signed permission slip by Friday.

> Select an email to read:

>3
From: Emma - Ideas for Our Universe

Hey, I had some ideas for the fictional world we're creating together! We should have flying narwhals, secret caves, and magical powers that only the bravest can use! Let me know what you think.

> Select an email to read:

>2
From: Mr. Anderson - Welcome to 5th Grade!

Dear Student, Welcome to 5th grade! We are excited to have you. Make sure to bring your materials on the first day. Your new teacher, Mr. Anderson.

> Select an email to read:

>1
From: Art Class Reminder - Reminder: Bring Your Crayons to Art Class!

This is a reminder to bring your crayons to art class next week. We'll be doing a special drawing activity.

> Select an email to read:

* * *

>x computer
The browser is open to your email inbox. You have 5 unread emails. You can select an email to read by typing a number from 1 to 5 or type `exit` to leave.

> Select an email to read:

>3
From: Emma - Ideas for Our Universe

Hey, I had some ideas for the fictional world we're creating together! We should have flying narwhals, secret caves, and magical powers that only the bravest can use! Let me know what you think.

> Select an email to read:

* * *

>4
From: School Admin - Field Trip to the Science Museum

Parents and Guardians, We are planning a field trip to the Science Museum next month. Please submit the signed permission slip by Friday.

> Select an email to read:

>5
From: Emma - Word Search from Emma

Hi! I made you a word search. It contains all my favourite neopets! It'll be fun.

> Select an email to read:

>2
From: Mr. Anderson - Welcome to 5th Grade!

Dear Student, Welcome to 5th grade! We are excited to have you. Make sure to bring your materials on the first day. Your new teacher, Mr. Anderson.

> Select an email to read:

>5
From: Emma - Word Search from Emma

Hi! I made you a word search. It contains all my favourite neopets! It'll be fun.

> Select an email to read:

* * *

>x room
You can't see any such thing.

>x
What do you want to examine?

>x here
You can't see any such thing.

>x bedroom
You can't see any such thing.

>x Bedroom
You can't see any such thing.

>x computer
The browser is open to your email inbox. You have 5 unread emails. You can select an email to read by typing a number from 1 to 5 or type `exit` to leave.

> Select an email to read:

* * *

>look
Bedroom
 .   \_/       .:"    .:"    .:"
 -=(_)=- /\ ||    /\||    /\||
 .   / \     //\\|   //\\|   //\\|
 .          //  \\  //  \\  //  \\
 .         //    \ ^/    \^/    \\
 .         |  ( )  ||  ( ) || ( ) |
 .         |       ||      ||      |%
 &%&--==--&%-==--%&

 It's weird to see things in 3D now. Your room has gone back to normal. There's an odd humming coming from your computer, though. .

 Beside you is a worn out drawer. To the south your kitchen fridge hums. To the north is a cramped closet.

>n
Closet
The closet is small and cramped, with a single cardboard box in the corner. It's dimly lit, and you can smell a faint musty odor, as if the space hasn't been opened in years. The walls are lined with old, forgotten coats, and the ceiling is low, making the space feel claustrophobic.

You can see a suitcase (closed) here.

>unlock suitcase
What do you want to unlock the suitcase with?

>unlock suitcase with key
Which do you mean, the crayola key or the silver key?

>unlock suitcase with silver key
> This suitcase requires a passcode:

>jubjub
The suitcase clicks open. Inside the suitcase is a collection of random objects, a yearbook, a record player, and a narwhal

>test
>--> No test scripts exist for this game.

>take all
yearbook: Taken. .

narwhal: Taken. An old hurt vibrates through you. You can't place why.

>i
You are carrying:
  narwhal
  a yearbook (open but empty)
  a crayola key
  a dandelion
  glasses
  crayons
  a journal (closed)
  a silver key

>drop narwhal
Dropped.

>read journal
You flip the pages randomly and arrive at page 3:

>x journal
A worn out journal in which you've taken to scrawling your dreams.

TABLE OF CONTENTS:
 1  TOYBOX
 2  ??????????
 3  ??????????

* * *

>eat candy
(first taking the candy)
You pocket the candy. It feels heavy, like nostalgia.

You unwrap the candy and pop it in your mouth. It tastes of a strange medley of flavours - vanilla custard, citrus, a hint of buttered toast. Delightful.

A sudden prickling rips through your throat, like you've swallowed something you shouldn't have. You double over, coughing, clutching the counter for balance. There's something lodged in your throat.

Clang! Out comes a small piece of metal. You pick it up, bewildered. It's a small key.

>go to kitchen
Kitchen
Your kitchen has seen better days. A fridge lies in one corner. Near the door is a row of plants with yellowing leaves. At the north corner is a door that leads onto the street.

You can see a jug, a plant, a note and a fridge (empty) here.

* * *

>unlock drawer
(with the silver key)
You unlock the drawer.

>take all
There are none at all available!

>open drawer
You pull open the drawer. A journal, a box of crayons, and a pair of glasses  lies inside. The journal beckons to you.

* * *

>take all
journal: Taken. A worn out journal in which you've taken to scrawling your dreams.

TABLE OF CONTENTS:
 1  TOYBOX
 2  ??????????
 3  ??????????

crayons: Taken. A bright yellow box. On it are instructions on how to draw certain shapes: a bunny, a lion, a narwhal, and a unicorn.

glasses: Taken. A wacky looking pair of with black frames and blue-purple swirling lenses. On the side are the words  Sentence Scrambler.

>read journal
You flip the pages randomly and arrive at page 4:

>ask emma about her wish
You can't see any such thing.

>ask her about wish
I'm not sure what 'her' refers to.

>ask emma about wish
You can't see any such thing.

>ask emma about what her wish is
You can't see any such thing.

>ask emma about what her wish is
You can't see any such thing.

>go to toybox
Toybox (Dreamland)
 |                  /\   
 |                 / | \ 
 |                / | | \ 
 |               /_|_|_|_
 |                |     / /
 |__    __    __ |    / /__    __    __
 |  |__|  |__|  |.   / /|  |__|  |__|  |
 |__            ____/ /___           __|
 |          / .------  )         |
 |         / /        /          |  TOYBOX
 |        / /        /           |
 ~~~~~~~~~~~~-----------~~~~~~~~

You open your eyes to pure whiteness. Every bit of empty space is blue lines, pink margins...

Margins! That's it. The world you're in is rendered on notebook paper. Objects are flat, paperlike, outlined in waxy lines. You look down at your hands and suppress a cry of shock. You're wearing a triangular smock of purple and your body is composed of black lines. You unfurl your fingers and watch as the lines retract and relax.

You take in the rest of your surroundings. You seem to be in a playground of sorts. There's a set of swings and a playstructure in a garish primary colours. In the distance is a forest, the paper trees swaying in the wind. One of the trees stands proudly in the center, a broken ladder propped against it.

A girl no older than five is playing in the field. She's crawling through the grass, plucking out a stem here and there.

>ask emma about wish
You can't see any such thing.

>ask emma about her wish
You can't see any such thing.

>ask emma wish
You can't see any such thing.

>ask emma wishes
You can't see any such thing.

>draw dandelion
(with the crayons) You doodle a dandelion. Looks cute. The air sizzles, and with a pop, the dandelion is splits from its surroundings. Something drops in your pocket.

>give dandelion to emma
You can't see any such thing.

>y
That was a rhetorical question.

>y
That was a rhetorical question.

>n
Plushieland
You wake up in world of cotton. Everything you see is rendered in a shade of pastel - the turgid river, the sky, the meadows in front of you. A girl around the age of seven is digging up flowers. Surrounding you are

>s
Toybox (Dreamland)
 |                  /\   
 |                 / | \ 
 |                / | | \ 
 |               /_|_|_|_
 |                |     / /
 |__    __    __ |    / /__    __    __
 |  |__|  |__|  |.   / /|  |__|  |__|  |
 |__            ____/ /___           __|
 |          / .------  )         |
 |         / /        /          |  TOYBOX
 |        / /        /           |
 ~~~~~~~~~~~~-----------~~~~~~~~

You open your eyes to pure whiteness. Every bit of empty space is blue lines, pink margins...

Margins! That's it. The world you're in is rendered on notebook paper. Objects are flat, paperlike, outlined in waxy lines. You look down at your hands and suppress a cry of shock. You're wearing a triangular smock of purple and your body is composed of black lines. You unfurl your fingers and watch as the lines retract and relax.

You take in the rest of your surroundings. You seem to be in a playground of sorts. There's a set of swings and a playstructure in a garish primary colours. In the distance is a forest, the paper trees swaying in the wind. One of the trees stands proudly in the center, a broken ladder propped against it.

A girl no older than five is playing in the field. She's crawling through the grass, plucking out a stem here and there.

>x computer
You can't see any such thing.

>turn on
What do you want to turn on?

>turn on computer
You can't see any such thing.

>x computer
You can't see any such thing.

>go to treehouse
The ladder is missing some rungs and isn't usable right now. You need to fix it first.

>go to toybox
Toybox (Dreamland)
 |                  /\   
 |                 / | \ 
 |                / | | \ 
 |               /_|_|_|_
 |                |     / /
 |__    __    __ |    / /__    __    __
 |  |__|  |__|  |.   / /|  |__|  |__|  |
 |__            ____/ /___           __|
 |          / .------  )         |
 |         / /        /          |  TOYBOX
 |        / /        /           |
 ~~~~~~~~~~~~-----------~~~~~~~~

You open your eyes to pure whiteness. Every bit of empty space is blue lines, pink margins...

Margins! That's it. The world you're in is rendered on notebook paper. Objects are flat, paperlike, outlined in waxy lines. You look down at your hands and suppress a cry of shock. You're wearing a triangular smock of purple and your body is composed of black lines. You unfurl your fingers and watch as the lines retract and relax.

You take in the rest of your surroundings. You seem to be in a playground of sorts. There's a set of swings and a playstructure in a garish primary colours. In the distance is a forest, the paper trees swaying in the wind. One of the trees stands proudly in the center, a broken ladder propped against it.

A girl no older than five is playing in the field. She's crawling through the grass, plucking out a stem here and there.

>x ladder
The ladder leans against the tree, but some of its rungs are missing.

>x tree
A knotted looking thing with a thick trunk. Leaning on it is a worm out ladder. Nestled in the branches is a winding structure, a treehouse of sorts.

>go to Treehouse
The ladder is missing some rungs and isn't usable right now. You need to fix it first.

>draw on ladder
What do you want to draw on the ladder with?

>draw on ladder with crayons
You use the crayon to draw in the missing rungs on the ladder. It now seems sturdy and ready to climb.

* * *

>climb ladder
You climb the ladder.

Treehouse
You have entered a cozy treehouse. It has a wooden floor, a small table with some board games, a hammock, and a girl named Emma who is sitting on a bean bag chair. There's a window with a view of the forest below.

You can see Emma here.

>say hi to emma
She crushes you in a hug. You found me!

>draw dandelion with crayons
(with the crayons) You doodle a dandelion with crayons. Looks cute.

>draw bunny
(with the crayons) You doodle a bunny. Looks cute.

>give dandelion to emma
Emma looks up at you in wonder. "A dandelion", she whispers reverentially. "I've never seen one before."

You tell her they're commonplace where you're from. "That can't be right," she says. "My grandma says they went extinct long ago. They were killed, you know. For being too resilient. She cups the fluffy white thing delicately. "C'mon! Let's wish together."

You put your heads together and your breaths create a flurry of white as the spores release into the air. You stare at this strange girl, wide-eyed with awe, twirling the empty stem in her hands. You're drawn to her uncomplicated joy.

"I wished for a friend," she says abruptly. She gazes at you in wonder. "I've never had a friend. Will you be my friend?

> Befriend Emma? Y/N

>y
Her face blooms with delight. "YAAAAY", she cries. "We can all be friends now. Me, you, Mr. Narkins.

Her face darkens for a second. "Have you seen him, by the way? He's a sea unicorn." You feel suction around you, like you're going through a vacuum. Everything blurs.

Bedroom
 .   \_/       .:"    .:"    .:"
 -=(_)=- /\ ||    /\||    /\||
 .   / \     //\\|   //\\|   //\\|
 .          //  \\  //  \\  //  \\
 .         //    \ ^/    \^/    \\
 .         |  ( )  ||  ( ) || ( ) |
 .         |       ||      ||      |%
 &%&--==--&%-==--%&

 To the south your kitchen fridge hums.

 Beside you is a worn out drawer. To the north is a cramped closet. 

That was a rhetorical question.

>go to toybox
Toybox (Dreamland)
 |                  /\   
 |                 / | \ 
 |                / | | \ 
 |               /_|_|_|_
 |                |     / /
 |__    __    __ |    / /__    __    __
 |  |__|  |__|  |.   / /|  |__|  |__|  |
 |__            ____/ /___           __|
 |          / .------  )         |
 |         / /        /          |  TOYBOX
 |        / /        /           |
 ~~~~~~~~~~~~-----------~~~~~~~~

You open your eyes to pure whiteness. Every bit of empty space is blue lines, pink margins...

Margins! That's it. The world you're in is rendered on notebook paper. Objects are flat, paperlike, outlined in waxy lines. You look down at your hands and suppress a cry of shock. You're wearing a triangular smock of purple and your body is composed of black lines. You unfurl your fingers and watch as the lines retract and relax.

You take in the rest of your surroundings. You seem to be in a playground of sorts. There's a set of swings and a playstructure in a garish primary colours. In the distance is a forest, the paper trees swaying in the wind. One of the trees stands proudly in the center, a broken ladder propped against it.

A girl no older than five is playing in the field. She's crawling through the grass, plucking out a stem here and there.

>go to treehouse
Treehouse
You have entered a cozy treehouse. It has a wooden floor, a small table with some board games, a hammock, and a girl named Emma who is sitting on a bean bag chair. There's a window with a view of the forest below.

You can see Emma here.

* * *

>open fridge
The fridge contains a jug and a piece of candy. The candy beckons to you.

>open fridge
That's already open.

>x fridge
There's a note stuck to the fridge. It reads   ¯¯̿̿¯̿̿"̿̿̿̿̿̿̿"̿̿"̿̿̿̿̿"̿̿̿)͇̿̿)̿̿̿̿ "̿̿̿̿̿̿\̵͇̿̿\=(•̪̀●́)=o/̵͇̿̿/"̿̿ ̿ ̿̿ ."

In the fridge are a chessboard, a potion labelled 'Drink Me', thumbtacks, diet coke and an apple.

>eat chessboard
(first taking the chessboard)
You eat the chessboard. Not bad.

>eat thumbtacks
(first taking thumbtacks)
You eat thumbtacks. Not bad.

>eat apple
(first taking the apple)
A strange warmth washes over you. Things start to look funny. Something falls in your pocket.

>ww
That's not a verb I recognise.

>w
You can't go that way.

>go to closet
Closet
It's empty except for a single cardbord box. You feel cramped.

You can see a cardboard box (closed) here.

>y
That was a rhetorical question.

>t
That's not a verb I recognise.

>e
You can't go that way.

>x
(the tiny steel key)
A stainless steel key, slightly bigger than your thumb.

>x
(the tiny steel key)
A stainless steel key, slightly bigger than your thumb.

>open box
Inside is a yearbook, a record player, a binder, and a 3D printed narwhal, amongst other odds and ends.
The closet smells dusty.

>open cardboard box
That's already open.

>x box
In the cardboard box are a yearbook, record player and narwhal.

>take yearbook
Taken.

>x yearbook
Class of XXYZ.

>take record player
Taken.

>switch on record player
You switch record player on.

Phoebe Bridgers fills the room.

>t
That's not a verb I recognise.

>d
You can't go that way.

Fall Out Boy fills the room.

>z
Time passes.

>z
Time passes.

>z
Time passes.

Fall Out Boy fills the room.

>z
Time passes.

Twice fills the room.

>z
Time passes.

Fall Out Boy fills the room.

>z
Time passes.

>z
Time passes.

Twice fills the room.

>z
Time passes.

Twenty One Pilots fills the room.

>z
Time passes.

Twice fills the room.

* * *

>z
Time passes.

Twenty One Pilots fills the room.

>z
Time passes.

Bruno Mars fills the room. You're on the verge of tears, but you're not sure why.

>z
Time passes.

Bruno Mars fills the room. You're on the verge of tears, but you're not sure why.

>z
Time passes.

Fall Out Boy fills the room.

* * *

>z
Time passes.

>z
Time passes.

Bruno Mars fills the room. You're on the verge of tears, but you're not sure why.

>z
Time passes.

Twice fills the room.

>z
Time passes.

Twice fills the room.

* * *

>z
Time passes.

Fall Out Boy fills the room.

>z
Time passes.

Twenty One Pilots fills the room.

>z
Time passes.

Twenty One Pilots fills the room.

>z
Time passes.

* * *

>z
Time passes.

Fall Out Boy fills the room.

>z
Time passes.

Fall Out Boy fills the room.

* * *

>z
Time passes.

Twenty One Pilots fills the room.

>z
Time passes.

Fall Out Boy fills the room.

>z
Time passes.

Bruno Mars fills the room. You're on the verge of tears, but you're not sure why.

>z
Time passes.

* * *

>z
Time passes.

Twice fills the room.

>z
Time passes.

* * *

>z
Time passes.

Bruno Mars fills the room. You're on the verge of tears, but you're not sure why.

>z
Time passes.

Twenty One Pilots fills the room.

* * *

>z
Time passes.

Twice fills the room.

>z
Time passes.

Bruno Mars fills the room. You're on the verge of tears, but you're not sure why.

>switch record player off
You switch record player off.

>z
Time passes.

* * *

>open fridge
The fridge contains a jug and a piece of candy. The candy beckons to you.

>take candy
You pocket the candy. It feels heavy, like nostalgia.

>eat candy
You unwrap the candy and pop it in your mouth. It tastes of a strange medley of flavours - vanilla custard, citrus, a hint of buttered toast. Delightful.

A sudden prickling rips through your throat, like you've swallowed something you shouldn't have. You double over, coughing, clutching the counter for balance. There's something lodged in your throat.

Clang! Out comes a small piece of metal. You pick it up, bewildered. It's a small key.

>i
You are carrying:
  a silver key

>e
Bedroom
 .   \_/       .:"    .:"    .:"
 -=(_)=- /\ ||    /\||    /\||
 .   / \     //\\|   //\\|   //\\|
 .          //  \\  //  \\  //  \\
 .         //    \ ^/    \^/    \\
 .         |  ( )  ||  ( ) || ( ) |
 .         |       ||      ||      |%
 &%&--==--&%-==--%&

You step into the bedroom and are flooded with emotion. Every inch of its surface now looks as if it's been dipped in iridescence. The walls are pulsating and warm, shifting from blue to red to violet. The scent of lilacs fill the air.  In the distance your kitchen fridge hums.

Lo-fi indie is playing from your computer. You notice movement on the screen. Beside you is a worn out drawer. To the left is a cramped closet.

>east
You can't go that way.

>unlock drawer w key
I didn't understand that sentence.

>unlock drawer with key
You unlock the drawer.

>open drawer
You pull open the drawer. A journal, a box of crayons, and a pair of glasses  lies inside. The journal beckons to you.

>take all
journal: Taken. A worn out journal in which you've taken to scrawling your dreams.

crayons: Taken. A bright yellow box. On it are instructions on how to draw certain shapes: a bunny, a lion, a narwhal, and a unicorn.

glasses: Taken. A wacky looking pair of with black frames and blue-purple swirling lenses. On the side are the words  Sentence Scrambler.

>open journal
You open the journal.

>read journal
You flip the pages randomly and arrive at page 4:

A thunderous crack cuts through the air. Everything begins to spin. You watch as everything around you dissolves and reforms until your eyes begin to burn from the distortion. 4. "???????"

Toybox (Dreamland)
 |                  /^\   / -- )
 |                 / | \ (____/
 |                / | | \ / /
 |               /_|_|_|_/ /
 |                |     / /
 | __    __    __ |    / /__    __    __
 |  |__|  |__|  |.   / /|  |__|  |__|  |
 |__            ____/ /___           __|
 |          / .------  )         |
 |         / /        /          |  TOYBOX
 |        / /        /           |
 ~~~~~~~~~~~~-----------~~~~~~~~

You open your eyes to pure whiteness. Every bit of empty space is blue lines, pink margins...

Margins! That's it. The world you're in is rendered on notebook paper. Objects are flat, paperlike, outlined in waxy lines. You look down at your hands and suppress a cry of shock. You're wearing a triangular smock of purple and your body is composed of black lines. You unfurl your fingers and watch as the lines retract and relax.

You take in the rest of your surroundings. You seem to be in a playground of sorts. There's a set of swings and a playstructure in a garish primary colours. In the distance is a forest, the paper trees swaying in the wind.

A girl no older than five is playing in the field. She's crawling through the grass, plucking out a stem here and there.

>x girl
A small girl wearing a checkered dress. Her hair is in neat plaits and her socks are mismatched. She looks familiar.

>x emma
A small girl wearing a checkered dress. Her hair is in neat plaits and her socks are mismatched. She looks familiar.

I beg your pardon?

>say hi to emma
She crushes you in a hug. You found me!

>say wish to emma
You feel it too, don't you? whispers the girl. This is a magic place.

>ask emma about name
Huuuh? I'm Emma, silly. Did you hit your head on the way down here?

>ask emma about drawing
C'mon! Let's draw together.

>ask emma what she’s looking for
Emma doesn't seem to hear you. She seems lost in a daydream.

>ask emma looking for
Emma is humming to herself.

>ask emma looking
Emma looks solemn, "I'm looking for something. It's a special plant. My grandma told me it's got special powers, and I need it to make a wish.

>draw narwhal with crayons
(with the crayons) You doodle a narwhal with crayons. Looks cute.

>draw narwhal
(with the crayons) You doodle a narwhal. Looks cute.

>i
You are carrying:
  glasses
  crayons
  a journal (open but empty)
  a silver key

>draw flower
(with the crayons) You doodle a flower. Looks cute.

>draw bunny
(with the crayons) You doodle a bunny. Looks cute. The air sizzles, and with a pop, the bunny is splits from its surroundings. Something drops in your pocket.

>draw dandelion
(with the crayons) You doodle a dandelion. Looks cute. The air sizzles, and with a pop, the dandelion is splits from its surroundings. Something drops in your pocket.

>i
You are carrying:
  a dandelion
  a bunny
  glasses
  crayons
  a journal (open but empty)
  a silver key

>give emma dandelion
Emma looks up at you in wonder. "A dandelion", she whispers reverentially. "I've never seen one before."

You tell her they're commonplace where you're from. "That can't be right," she says. "My grandma says they went extinct long ago. They were killed, you know. For being too resilient. She cups the fluffy white thing delicately. "C'mon! Let's wish together."

You put your heads together and your breaths create a flurry of white as the spores release into the air. You stare at this strange girl, wide-eyed with awe, twirling the empty stem in her hands. You're drawn to her uncomplicated joy.

"I wished for a friend," she says abruptly. She gazes at you in wonder. "I've never had a friend. Will you be my friend?

> Befriend Emma? Y/N

>y
YAY.

That was a rhetorical question.

>i
You are carrying:
  a crayola key
  a dandelion
  a bunny
  glasses
  crayons
  a journal (open but empty)
  a silver key

* * *

>go to kitchen
Kitchen
Your kitchen has seen better days. A fridge lies in one corner. Near the door is a row of plants with yellowing leaves. At the north corner is a door that leads onto the street.

You can see a jug, a plant, a note and a fridge (closed) here.

>read note
You flip the pages randomly and arrive at page 3:

The drawer isn't open.

* * *

>go to kitchen
Kitchen
Your kitchen has seen better days. A fridge lies in one corner. Near the door is a row of plants with yellowing leaves. At the north corner is a door that leads onto the street.

You can see a jug, a plant, a note and a fridge (closed) here.

>water plant
The plant looks a little less dead.

* * *

>go to kitchen
Kitchen
Your kitchen has seen better days. A fridge lies in one corner. Near the door is a row of plants with yellowing leaves. At the north corner is a door that leads onto the street.

You can see a jug, a plant, a note and a fridge (closed) here.

>x note
There's a note stuck to the fridge. It reads  ¯¯̿̿¯̿̿"̿̿̿̿̿̿̿"̿̿"̿̿̿̿̿"̿̿̿)͇̿̿)̿̿̿̿ "̿̿̿̿̿̿\̵͇̿̿\=(•̪̀●́)=o/̵͇̿̿/"̿̿ ̿ ̿̿ ."

>open fridge
The fridge contains ?????? ??? ?? ????? ??????? ??????? ?? ????
 and curiously, a piece of candy. The candy beckons to you.

>eat candy
(first taking the candy)
You pocket the candy. It feels heavy, like nostalgia.

You unwrap the candy and pop it in your mouth. It tastes of a strange medley of flavours - vanilla custard, citrus, a hint of buttered toast. Delightful.

A sudden prickling rips through your throat, like you've swallowed something you shouldn't have. You double over, coughing, clutching the counter for balance. There's something lodged in your throat.

Clang! Out comes a small piece of metal. You pick it up, bewildered. It's a small key.

>go to bedroom
Bedroom
 .   \_/       .:"    .:"    .:"
 -=(_)=- /\ ||    /\||    /\||
 .   / \     //\\|   //\\|   //\\|
 .          //  \\  //  \\  //  \\
 .         //    \ ^/    \^/    \\
 .         |  ( )  ||  ( ) || ( ) |
 .         |       ||      ||      |%
 &%&--==--&%-==--%&

You step into the bedroom and are flooded with emotion. Every inch of its surface now looks as if it's been dipped in. The walls are pulsating and warm, shifting from blue to red to violet.  In the distance your kitchen fridge hums.

Lo-fi indie is playing from your computer. You notice movement on the screen. Beside you is a worn out drawer. To the left is a cramped closet.

>unlock drawer
(with the silver key)
You unlock the drawer.

* * *

>take all
journal: Taken. A worn out journal in which you've taken to scrawling your dreams.

crayons: Taken. A bright yellow box. On it are instructions on how to draw certain shapes: a bunny, a lion, a narwhal, and a unicorn.

glasses: Taken. A wacky looking pair of with black frames and blue-purple swirling lenses. On the side are the words  Sentence Scrambler.

>read journal
You flip the pages randomly and arrive at page 1:

A thunderous crack cuts through the air. Everything begins to spin. You watch as everything around you dissolves and reforms until your eyes begin to burn from the distortion. 1. "TOYBOX"

Toybox (Dreamland)
 |                  /^\   / -- )
 |                 / | \ (____/
 |                / | | \ / /
 |               /_|_|_|_/ /
 |                |     / /
 | __    __    __ |    / /__    __    __
 |  |__|  |__|  |.   / /|  |__|  |__|  |
 |__            ____/ /___           __|
 |          / .------  )         |
 |         / /        /          |  TOYBOX
 |        / /        /           |
 ~~~~~~~~~~~~-----------~~~~~~~~

You open your eyes to pure whiteness. Every bit of empty space is blue lines, pink margins...

Margins! That's it. The world you're in is rendered on notebook paper. Objects are flat, paperlike, outlined in waxy lines. You look down at your hands and suppress a cry of shock. You're wearing a triangular smock of purple and your body is composed of black lines. You unfurl your fingers and watch as the lines retract and relax.

You take in the rest of your surroundings. You seem to be in a playground of sorts. There's a set of swings and a playstructure in a garish primary colours. In the distance is a forest, the paper trees swaying in the wind.

A girl no older than five is playing in the field. She's crawling through the grass, plucking out a stem here and there.

>talk to girl
That's not a verb I recognise.

>say hi to girl
She crushes you in a hug. You found me!

* * *

>go to toybox
Toybox (Dreamland)
 |                  /\   
 |                 / | \ 
 |                / | | \ 
 |               /_|_|_|_
 |                |     / /
 |__    __    __ |    / /__    __    __
 |  |__|  |__|  |.   / /|  |__|  |__|  |
 |__            ____/ /___           __|
 |          / .------  )         |
 |         / /        /          |  TOYBOX
 |        / /        /           |
 ~~~~~~~~~~~~-----------~~~~~~~~

You open your eyes to pure whiteness. Every bit of empty space is blue lines, pink margins...

Margins! That's it. The world you're in is rendered on notebook paper. Objects are flat, paperlike, outlined in waxy lines. You look down at your hands and suppress a cry of shock. You're wearing a triangular smock of purple and your body is composed of black lines. You unfurl your fingers and watch as the lines retract and relax.

You take in the rest of your surroundings. You seem to be in a playground of sorts. There's a set of swings and a playstructure in a garish primary colours. In the distance is a forest, the paper trees swaying in the wind. One of the trees stands proudly in the center, a broken ladder propped against it.

A girl no older than five is playing in the field. She's crawling through the grass, plucking out a stem here and there.

>go to treehouse
The ladder is missing some rungs and isn't usable right now. You need to fix it first.

>draw on ladder with crayons
You can't see any such thing.

>go to bedroom
Bedroom
 .   \_/       .:"    .:"    .:"
 -=(_)=- /\ ||    /\||    /\||
 .   / \     //\\|   //\\|   //\\|
 .          //  \\  //  \\  //  \\
 .         //    \ ^/    \^/    \\
 .         |  ( )  ||  ( ) || ( ) |
 .         |       ||      ||      |%
 &%&--==--&%-==--%&

Your bedroom is unadorned. The walls are chalky and the ground bare. The only decoration is a poster of The Killers. A lightbulb hangs from the ceiling. A tiny window is opened a crack, and the sound of faint static comes through. To the south your kitchen fridge hums.

In the corner your monitor blinks wearily. You must've forgotten to turn it off.  Beside you is a worn out drawer. To the north is a cramped closet.

>go to kitcken
That noun did not make sense in this context.

>go to kitchen
Kitchen
Your kitchen has seen better days. A fridge lies in one corner. Near the door is a row of plants with yellowing leaves. At the north corner is a door that leads onto the street.

You can see a jug, a plant, a note and a fridge (closed) here.

* * *

>eat candy
(first taking the candy)
You pocket the candy. It feels heavy, like nostalgia.

You unwrap the candy and pop it in your mouth. It tastes of a strange medley of flavours - vanilla custard, citrus, a hint of buttered toast. Delightful.

A sudden prickling rips through your throat, like you've swallowed something you shouldn't have. You double over, coughing, clutching the counter for balance. There's something lodged in your throat.

Clang! Out comes a small piece of metal. You pick it up, bewildered. It's a small key.

>go to bedroom
Bedroom
 .   \_/       .:"    .:"    .:"
 -=(_)=- /\ ||    /\||    /\||
 .   / \     //\\|   //\\|   //\\|
 .          //  \\  //  \\  //  \\
 .         //    \ ^/    \^/    \\
 .         |  ( )  ||  ( ) || ( ) |
 .         |       ||      ||      |%
 &%&--==--&%-==--%&

You step into the bedroom and are flooded with emotion. Every inch of its surface now looks as if it's been dipped in. The walls are pulsating and warm, shifting from blue to red to violet.  To the south your kitchen fridge hums.

Lo-fi indie is playing from your computer. You notice movement on the screen. Beside you is a worn out drawer. To the north is a cramped closet.

* * *

>take all
journal: Taken. A worn out journal in which you've taken to scrawling your dreams.

TABLE OF CONTENTS:
 1  TOYBOX
 2  ??????????
 3  ??????????

crayons: Taken. A bright yellow box. On it are instructions on how to draw certain shapes: a bunny, a lion, a narwhal, and a unicorn.

glasses: Taken. A wacky looking pair of with black frames and blue-purple swirling lenses. On the side are the words  Sentence Scrambler.

>read journal
You flip the pages randomly and arrive at page 3:

>read page 1 of journal
A thunderous crack cuts through the air. Everything begins to spin. You watch as everything around you dissolves and reforms until your eyes begin to burn from the distortion. 1. "TOYBOX"

Toybox (Dreamland)
 |                  /\   
 |                 / | \ 
 |                / | | \ 
 |               /_|_|_|_
 |                |     / /
 |__    __    __ |    / /__    __    __
 |  |__|  |__|  |.   / /|  |__|  |__|  |
 |__            ____/ /___           __|
 |          / .------  )         |
 |         / /        /          |  TOYBOX
 |        / /        /           |
 ~~~~~~~~~~~~-----------~~~~~~~~

You open your eyes to pure whiteness. Every bit of empty space is blue lines, pink margins...

Margins! That's it. The world you're in is rendered on notebook paper. Objects are flat, paperlike, outlined in waxy lines. You look down at your hands and suppress a cry of shock. You're wearing a triangular smock of purple and your body is composed of black lines. You unfurl your fingers and watch as the lines retract and relax.

You take in the rest of your surroundings. You seem to be in a playground of sorts. There's a set of swings and a playstructure in a garish primary colours. In the distance is a forest, the paper trees swaying in the wind. One of the trees stands proudly in the center, a broken ladder propped against it.

A girl no older than five is playing in the field. She's crawling through the grass, plucking out a stem here and there.

* * *

>climb ladder
You climb the ladder.

Treehouse
You have entered a cozy treehouse. It has a wooden floor, a small table with some board games, a hammock, and a girl named Emma who is sitting on a bean bag chair. There's a window with a view of the forest below.

You can see Emma here.

>draw dandelion
I didn't understand that sentence.

>draw dandelion with crayons
You use the crayons to carefully draw a bright yellow dandelion. The petals are vivid, and the stem is a bright green. The drawing looks almost alive.

The air sizzles, and with a pop, something drops in your pocket

>i
You are carrying:
  a dandelion
  glasses
  crayons
  a journal (closed)
  a silver key

>draw dandelion
I didn't understand that sentence.

>give dandelion to emma
Emma looks up at you in wonder. "A dandelion", she whispers reverentially. "I've never seen one before."

You tell her they're commonplace where you're from. "That can't be right," she says. "My grandma says they went extinct long ago. They were killed, you know. For being too resilient. She cups the fluffy white thing delicately. "C'mon! Let's wish together."

You put your heads together and your breaths create a flurry of white as the spores release into the air. You stare at this strange girl, wide-eyed with awe, twirling the empty stem in her hands. You're drawn to her uncomplicated joy.

"I wished for a friend," she says abruptly. She gazes at you in wonder. "I've never had a friend. Will you be my friend?

> Befriend Emma? Y/N

>y
Her face blooms with delight. "YAAAAY", she cries. "We can all be friends now. Me, you, Mr. Narkins.

Her face darkens for a second. "Have you seen him, by the way? He's a sea unicorn." You feel suction around you, like you're going through a vacuum. Everything blurs.

Bedroom
 .   \_/       .:"    .:"    .:"
 -=(_)=- /\ ||    /\||    /\||
 .   / \     //\\|   //\\|   //\\|
 .          //  \\  //  \\  //  \\
 .         //    \ ^/    \^/    \\
 .         |  ( )  ||  ( ) || ( ) |
 .         |       ||      ||      |%
 &%&--==--&%-==--%&

 It's weird to see things in 3D now. Your room has gone back to normal. There's an odd humming coming from your computer, though.  To the south your kitchen fridge hums.

 Beside you is a worn out drawer. To the north is a cramped closet. 

That was a rhetorical question.

>x computer
A yellowing Windows XP that's seen better days. 

The computer is currently switched off.

>switch on
What do you want to switch on?

>switch on computer
The monitor lights up with a staticky pop. 
You switch the computer on.

>x computer
 A browser is open to a new tab. In the bookmarks are several pages - neopets, AOL, club penguin. Tne neopets browser has a username and password field.

J U B J U B X A
 P X O X G L E P
 K A C H E E K O
 X G I H J K L O
 M N O P Q R S G
 T O V W X Y Z L
 T O V W X Y Z E
  

The computer is currently switched on.

>read email 1
You can't see any such thing.

>read email 2
You can't see any such thing.

>x computer
 A browser is open to a new tab. In the bookmarks are several pages - neopets, AOL, club penguin. Tne neopets browser has a username and password field.

J U B J U B X A
 P X O X G L E P
 K A C H E E K O
 X G I H J K L O
 M N O P Q R S G
 T O V W X Y Z L
 T O V W X Y Z E
  

The computer is currently switched on.

>go to bedroom
Bedroom
 .   \_/       .:"    .:"    .:"
 -=(_)=- /\ ||    /\||    /\||
 .   / \     //\\|   //\\|   //\\|
 .          //  \\  //  \\  //  \\
 .         //    \ ^/    \^/    \\
 .         |  ( )  ||  ( ) || ( ) |
 .         |       ||      ||      |%
 &%&--==--&%-==--%&

 It's weird to see things in 3D now. Your room has gone back to normal. There's an odd humming coming from your computer, though.  To the south your kitchen fridge hums.

 Beside you is a worn out drawer. To the north is a cramped closet.

>turn on computer
That's already on.

>read email 1
You can't see any such thing.

>go to kitcken
That noun did not make sense in this context.

>x computer
 A browser is open to a new tab. In the bookmarks are several pages - neopets, AOL, club penguin. Tne neopets browser has a username and password field.

J U B J U B X A
 P X O X G L E P
 K A C H E E K O
 X G I H J K L O
 M N O P Q R S G
 T O V W X Y Z L
 T O V W X Y Z E
  

The computer is currently switched on.

* * *

>read email 1
You can't see any such thing.

>read email
You can't see any such thing.

>read email 4
You can't see any such thing.

>read email
You can't see any such thing.

* * *

>help
 Here are some instructions to get you started:
 • Use "look" to observe your surroundings.
 • Use "take item" or "take all" to pick up items.
 • Use "inventory" or "i" to see what you're carrying.
 • Use "go direction" to move around (e.g., "go north" or simply "n" or "s").
 • For more details, try interacting with objects using "examine item" or "x item".
 • Visit: https://tinyurl.com/inform-cheatsheet for more commands.

>help
 Here are some instructions to get you started:
 - Use "look" to observe your surroundings.
 - Use "take item" to pick up items.
 - Use "inventory" or "i" to see what you're carrying.
 - Use "go direction" to move around (e.g., "go north" or simply "n" or "s").
 - For more details, try interacting with objects using "examine item" or "x item".
 - Visit: https://tinyurl.com/inform-cheatsheet for more commands.

>look
Bedroom
 .   \_/       .:"    .:"    .:"
 -=(_)=- /\ ||    /\||    /\||
 .   / \     //\\|   //\\|   //\\|
 .          //  \\  //  \\  //  \\
 .         //    \ ^/    \^/    \\
 .         |  ( )  ||  ( ) || ( ) |
 .         |       ||      ||      |%
 &%&--==--&%-==--%&

Your bedroom is unadorned. The walls are chalky and the ground bare. The only decoration is a poster of The Killers. A lightbulb hangs from the ceiling. A tiny window is opened a crack, and the sound of faint static comes through.

In the corner your monitor blinks wearily. You must've forgotten to turn it off.  Beside you is a worn out drawer. To the north your kitchen fridge hums. To the south is a cramped closet.

>help
 Here are some instructions to get you started:
 - Use "look" to observe your surroundings.
 - Use "take item" to pick up items.
 - Use "inventory" or "i" to see what you're carrying.
 - Use "go direction" to move around (e.g., "go north" or simply "n" or "s").
 - For more details, try interacting with objects using "examine item" or "x item".
 - Visit: https://tinyurl.com/inform-cheatsheet for more commands.

>s
Closet
The closet is small and cramped, with a suitcase in the corner. It's dimly lit, and you can smell a faint musty odor, as if the space hasn't been opened in years. The walls are lined with old, forgotten coats, and the ceiling is low, making the space feel claustrophobic.

You can see a suitcase (closed) and a keypad here.

>n
Bedroom
 .   \_/       .:"    .:"    .:"
 -=(_)=- /\ ||    /\||    /\||
 .   / \     //\\|   //\\|   //\\|
 .          //  \\  //  \\  //  \\
 .         //    \ ^/    \^/    \\
 .         |  ( )  ||  ( ) || ( ) |
 .         |       ||      ||      |%
 &%&--==--&%-==--%&

Your bedroom is unadorned. The walls are chalky and the ground bare. The only decoration is a poster of The Killers. A lightbulb hangs from the ceiling. A tiny window is opened a crack, and the sound of faint static comes through.

In the corner your monitor blinks wearily. You must've forgotten to turn it off.  Beside you is a worn out drawer. To the north your kitchen fridge hums. To the south is a cramped closet.

>n
Kitchen
Your kitchen has seen better days. A fridge lies in one corner. Near the door is a row of plants with yellowing leaves.

You can see a jug, a plant, a note and a fridge (closed) here.

>open fridge
The fridge contains a jug and a piece of candy. The candy beckons to you.

>eat candy
(first taking the candy)
You pocket the candy. It feels heavy, like nostalgia.

You unwrap the candy and pop it in your mouth. It tastes of a strange medley of flavours - vanilla custard, citrus, a hint of buttered toast. Delightful.

A sudden prickling rips through your throat, like you've swallowed something you shouldn't have. You double over, coughing, clutching the counter for balance. There's something lodged in your throat.

Clang! Out comes a small piece of metal. You pick it up, bewildered. It's a small key.

You can press i to view your inventory.

>i
You are carrying:
  a silver key

>s
Bedroom
 .   \_/       .:"    .:"    .:"
 -=(_)=- /\ ||    /\||    /\||
 .   / \     //\\|   //\\|   //\\|
 .          //  \\  //  \\  //  \\
 .         //    \ ^/    \^/    \\
 .         |  ( )  ||  ( ) || ( ) |
 .         |       ||      ||      |%
 &%&--==--&%-==--%&

You step into the bedroom and are flooded with emotion. Every inch of its surface now looks as if it's been dipped in. The walls are pulsating and warm, shifting from blue to red to violet. 

Lo-fi indie is playing from your computer. You notice movement on the screen. Beside you is a worn out drawer. To the north your kitchen fridge hums. To the south is a cramped closet.

>open drawer
It seems to be locked.

>open drawer with key
The drawer yawns open lazily. In it are a journal, crayons and glasses.

>take all
journal: Taken. A worn out journal in which you've taken to scrawling your dreams.

TABLE OF CONTENTS:
 0. BEDROOM 
 1.  TOYBOX
 2.  ?????
 3. ?????

You can read the journal by typing: read page N of journal.

crayons: Taken. A bright yellow box. On it are instructions on how to draw certain shapes: a bunny, a lion, a narwhal, and a unicorn. Good for fixing things, if you're in the right place.

To draw something with the crayons, type: draw `object` with crayons.

glasses: Taken. A wacky looking pair of with black frames and blue-purple swirling lenses. On the side are the words  Sentence Scrambler.

>read page 1 of journal
A thunderous crack cuts through the air. Everything begins to spin. You watch as everything around you dissolves and reforms until your eyes begin to burn from the distortion.

Toybox (Dreamland)
 |                  /\   
 |                 / | \ 
 |                / | | \ 
 |               /_|_|_|_
 |                |     / /
 |__    __    __ |    / /__    __    __
 |  |__|  |__|  |.   / /|  |__|  |__|  |
 |__            ____/ /___           __|
 |          / .------  )         |
 |         / /        /          |  TOYBOX
 |        / /        /           |
 ~~~~~~~~~~~~-----------~~~~~~~~

You open your eyes to pure whiteness. Every bit of empty space is blue lines, pink margins...

Margins! That's it. The world you're in is rendered on notebook paper. Objects are flat, paperlike, outlined in waxy lines. You look down at your hands and suppress a cry of shock. You're wearing a triangular smock of purple and your body is composed of black lines. You unfurl your fingers and watch as the lines retract and relax.

You take in the rest of your surroundings. You seem to be in a playground of sorts. There's a set of swings and a playstructure in a garish primary colours. In the distance is a forest, the paper trees swaying in the wind. One of the trees stands proudly in the center, a broken ladder propped against it.

>read page 0 of journal
A thunderous crack cuts through the air. Everything begins to spin. You watch as everything around you dissolves and reforms until your eyes begin to burn from the distortion.

Bedroom
 .   \_/       .:"    .:"    .:"
 -=(_)=- /\ ||    /\||    /\||
 .   / \     //\\|   //\\|   //\\|
 .          //  \\  //  \\  //  \\
 .         //    \ ^/    \^/    \\
 .         |  ( )  ||  ( ) || ( ) |
 .         |       ||      ||      |%
 &%&--==--&%-==--%&

You step into the bedroom and are flooded with emotion. Every inch of its surface now looks as if it's been dipped in. The walls are pulsating and warm, shifting from blue to red to violet. 

Lo-fi indie is playing from your computer. You notice movement on the screen. Beside you is a worn out drawer. To the north your kitchen fridge hums. To the south is a cramped closet.

>read page 1 of journal
A thunderous crack cuts through the air. Everything begins to spin. You watch as everything around you dissolves and reforms until your eyes begin to burn from the distortion.

Toybox (Dreamland)
 |                  /\   
 |                 / | \ 
 |                / | | \ 
 |               /_|_|_|_
 |                |     / /
 |__    __    __ |    / /__    __    __
 |  |__|  |__|  |.   / /|  |__|  |__|  |
 |__            ____/ /___           __|
 |          / .------  )         |
 |         / /        /          |  TOYBOX
 |        / /        /           |
 ~~~~~~~~~~~~-----------~~~~~~~~

You open your eyes to pure whiteness. Every bit of empty space is blue lines, pink margins...

Margins! That's it. The world you're in is rendered on notebook paper. Objects are flat, paperlike, outlined in waxy lines. You look down at your hands and suppress a cry of shock. You're wearing a triangular smock of purple and your body is composed of black lines. You unfurl your fingers and watch as the lines retract and relax.

You take in the rest of your surroundings. You seem to be in a playground of sorts. There's a set of swings and a playstructure in a garish primary colours. In the distance is a forest, the paper trees swaying in the wind. One of the trees stands proudly in the center, a broken ladder propped against it.

>x crayons
A bright yellow box. On it are instructions on how to draw certain shapes: a bunny, a lion, a narwhal, and a unicorn. Good for fixing things, if you're in the right place.

To draw something with the crayons, type: draw `object` with crayons.

>draw bunny with crayons
You doodle a cute bunny on the page. Its long ears and fluffy tail make it look adorable.

>draw dolphin with crayons
You draw dolphin with your crayons. It looks decent, but it's not your best work.

>draw do with crayons
You draw do with your crayons. It looks decent, but it's not your best work.

>draw lion with crayons
You draw lion with your crayons. It looks decent, but it's not your best work.

>draw penius with crayons
You draw penius with your crayons. It looks decent, but it's not your best work.

>draw penus with crayons
You draw penus with your crayons. It looks decent, but it's not your best work.

>draw ladder with crayons
You color in the missing gaps with the silver crayon. Good as new.

>helpd
That's not a verb I recognise.

>draw on ladder with crayons
You have already fixed the ladder.

>climb ladder
You climb the ladder.

Treehouse
You have entered a cozy treehouse. It has a wooden floor, a small table with some board games, a hammock, and a small girl around the age of 6. There's a window with a view of the forest below.

The girl is doodling furiously. It's some sort of composition of flowers. Every now and then she pauses to wipe her wax-covered hands on her skirt. When she sees you, she cries out in delight.

"I see you managed to fix the ladder," she says. I was getting bored up here. What took you so long?"

>d
You can't go that way.

>read page 1 of journal
A thunderous crack cuts through the air. Everything begins to spin. You watch as everything around you dissolves and reforms until your eyes begin to burn from the distortion.

Toybox (Dreamland)
 |                  /\   
 |                 / | \ 
 |                / | | \ 
 |               /_|_|_|_
 |                |     / /
 |__    __    __ |    / /__    __    __
 |  |__|  |__|  |.   / /|  |__|  |__|  |
 |__            ____/ /___           __|
 |          / .------  )         |
 |         / /        /          |  TOYBOX
 |        / /        /           |
 ~~~~~~~~~~~~-----------~~~~~~~~

You open your eyes to pure whiteness. Every bit of empty space is blue lines, pink margins...

Margins! That's it. The world you're in is rendered on notebook paper. Objects are flat, paperlike, outlined in waxy lines. You look down at your hands and suppress a cry of shock. You're wearing a triangular smock of purple and your body is composed of black lines. You unfurl your fingers and watch as the lines retract and relax.

You take in the rest of your surroundings. You seem to be in a playground of sorts. There's a set of swings and a playstructure in a garish primary colours. In the distance is a forest, the paper trees swaying in the wind. One of the trees stands proudly in the center, a broken ladder propped against it.

* * *

I beg your pardon?

>z
Time passes.

>s
Closet
The closet is small and cramped, with a suitcase in the corner. It's dimly lit, and you can smell a faint musty odor, as if the space hasn't been opened in years. The walls are lined with old, forgotten coats, and the ceiling is low, making the space feel claustrophobic.

You can see a suitcase (closed) and a keypad here.

>n
Bedroom
 .   \_/       .:"    .:"    .:"
 -=(_)=- /\ ||    /\||    /\||
 .   / \     //\\|   //\\|   //\\|
 .          //  \\  //  \\  //  \\
 .         //    \ ^/    \^/    \\
 .         |  ( )  ||  ( ) || ( ) |
 .         |       ||      ||      |%
 &%&--==--&%-==--%&

You step into the bedroom and are flooded with emotion. Every inch of its surface now looks as if it's been dipped in. The walls are pulsating and warm, shifting from blue to red to violet. 

Lo-fi indie is playing from your computer. You notice movement on the screen. Beside you is a worn out drawer. To the north your kitchen fridge hums. To the south is a cramped closet.

>n
Kitchen
Your kitchen has seen better days. A fridge lies in one corner. Near the door is a row of plants with yellowing leaves.

You can see a jug, a plant, a note and a fridge (empty) here.

>take jug
Taken. It's filled with water.

>water plant with jug
You water the plant with the jug. The plant perks up a little.

* * *

>help
 Here are some instructions to get you started:
 • Use "look" to observe your surroundings.
 • Use "take item" or "take all" to pick up items.
 • Use "inventory" or "i" to see what you're carrying.
 • Use "go direction" to move around (e.g., "go north" or simply "n" or "s").
 • For more details, try interacting with objects using "examine item" or "x item".
 • Visit: https://tinyurl.com/inform-cheatsheet for more commands.

>n
Kitchen
Your kitchen has seen better days. A fridge lies in one corner. Near the door is a row of plants with yellowing leaves.

You can see a jug, a plant, a note and a fridge (closed) here.

* * *

>eat candy
(first taking the candy)
You pocket the candy. It feels heavy, like nostalgia.

You unwrap the candy and pop it in your mouth. It tastes of a strange medley of flavours - vanilla custard, citrus, a hint of buttered toast. Delightful.

A sudden prickling rips through your throat, like you've swallowed something you shouldn't have. You double over, coughing, clutching the counter for balance. There's something lodged in your throat.

Clang! Out comes a small piece of metal. You pick it up, bewildered. It's a small key.

You can press i to view your inventory.

>n
You can't go that way.

>s
Bedroom
 .   \_/       .:"    .:"    .:"
 -=(_)=- /\ ||    /\||    /\||
 .   / \     //\\|   //\\|   //\\|
 .          //  \\  //  \\  //  \\
 .         //    \ ^/    \^/    \\
 .         |  ( )  ||  ( ) || ( ) |
 .         |       ||      ||      |%
 &%&--==--&%-==--%&

You step into the bedroom and are flooded with emotion. Every inch of its surface now looks as if it's been dipped in. The walls are pulsating and warm, shifting from blue to red to violet. 

Lo-fi indie is playing from your computer. You notice movement on the screen. Beside you is a worn out drawer. To the north your kitchen fridge hums. To the south is a cramped closet.

* * *

>draw dandelion with crayons
You use the crayons to carefully draw a bright yellow dandelion. The petals are vivid, and the stem is a bright green. The drawing looks almost alive.

The air sizzles, and with a pop, something drops in your pocket

* * *

>i
You are carrying:
  a dandelion
  glasses
  crayons
  a journal (closed)
  a silver key

>draw ladder
I didn't understand that sentence.

>draw ladder with crayons
You color in the missing gaps with the silver crayon. Good as new.

>climb ladder
You grip the edges of the ladder cautiously, and hoist yourself up. Half of you expects the scribbled lines to give way, but they hold steady. After a few minutes of climbing, you are met with a trapdoor. You push on the latch.

Treehouse
You have entered a cozy treehouse. It has a wooden floor, a small table with some board games, a hammock, and a small girl around the age of 6. There's a window with a view of the forest below.

The girl is doodling furiously. It's some sort of composition of flowers. Every now and then she pauses to wipe her wax-covered hands on her skirt. When she sees you, she cries out in delight.

"I see you managed to fix the ladder," she says. I was getting bored up here. What took you so long?"

>x girl
A small girl wearing a checkered dress. Her hair is in neat plaits and her socks are mismatched. She looks familiar. 

You can interact with her by typing: ask girl about `topic`. The topic should be a singular word.

>give dandelion to girl
Emma looks up at you in wonder. "A dandelion", she whispers reverentially. "I've never seen one before."

You tell her they're commonplace where you're from. "That can't be right," she says. "My grandma says they went extinct long ago. They were killed, you know. For being too resilient. She cups the fluffy white thing delicately. "C'mon! Let's wish together."

You put your heads together and your breaths create a flurry of white as the spores release into the air. You stare at this strange girl, wide-eyed with awe, twirling the empty stem in her hands. You're drawn to her uncomplicated joy.

"I wished for a friend," she says abruptly. She gazes at you in wonder. "I've never had a friend. Will you be my friend?

> Befriend Emma? Y/N

>y
Her face blooms with delight. "YAAAAY", she cries. "We can all be friends now. Me, you, Mr. Narkins.

Her face darkens for a second. "Have you seen him, by the way? He's a sea unicorn." You feel suction around you, like you're going through a vacuum. Everything blurs.

Bedroom
 .   \_/       .:"    .:"    .:"
 -=(_)=- /\ ||    /\||    /\||
 .   / \     //\\|   //\\|   //\\|
 .          //  \\  //  \\  //  \\
 .         //    \ ^/    \^/    \\
 .         |  ( )  ||  ( ) || ( ) |
 .         |       ||      ||      |%
 &%&--==--&%-==--%&

 It's weird to see things in 3D now. Your room has gone back to normal. There's an odd humming coming from your computer, though. 

 Beside you is a worn out drawer. To the north your kitchen fridge hums. To the south is a cramped closet.

>x computer
 A browser is open to an email inbox. You have several unread emails.  

The computer is currently switched on.

The browser is open to your email inbox. You have 5 unread emails. You can select an email to read by typing a number from 1 to 5. You can type `exit` to leave.
> Select an email to read:

>1
From: Art Class Reminder - Reminder: Bring Your Crayons to Art Class!

This is a reminder to bring your crayons to art class next week. We'll be doing a special drawing activity.

> Select an email to read:

* * *

>2
From: Mr. Anderson - Welcome to 5th Grade!

Dear Student, Welcome to 5th grade! We are excited to have you. Make sure to bring your materials on the first day. Your new teacher, Mr. Anderson.

> Select an email to read:

>3
From: Emma - Ideas for Plushieland

Hey, I had some ideas for the fictional world we're creating together! We should have flying narwhals, secret caves, and magical powers that only the bravest can use! Let me know what you think.

> Select an email to read:

>4
From: School Admin - Field Trip to the Science Museum

Parents and Guardians, We are planning a field trip to the Science Museum next month. Please submit the signed permission slip by Friday.

> Select an email to read:

>5
From: Emma - Word Search from Emma

Hi! I made you a word search. It's neopet themed!

. J T A M X I L L S A
 H Y B Z A P F Z X R
 U R E D O U B L E P
 D F S E T Y W E T I
 O L I L I S H A E N
 R J N L O F A E U J
 A F F G C I D O L S
 P A I N T B R U S H
 B I L L U S E N F T
 J U B J U B A S S G
 
> Select an email to read:

* * *

>go to closet
Closet
The closet is small and cramped, with a suitcase in the corner. It's dimly lit, and you can smell a faint musty odor, as if the space hasn't been opened in years. The walls are lined with old, forgotten coats, and the ceiling is low, making the space feel claustrophobic.

You can see a suitcase (closed) and a keypad here.

>go to toybox
Toybox (Dreamland)
 |                  /\   
 |                 / | \ 
 |                / | | \ 
 |               /_|_|_|_
 |                |     / /
 |__    __    __ |    / /__    __    __
 |  |__|  |__|  |.   / /|  |__|  |__|  |
 |__            ____/ /___           __|
 |          / .------  )         |
 |         / /        /          |  TOYBOX
 |        / /        /           |
 ~~~~~~~~~~~~-----------~~~~~~~~

You open your eyes to pure whiteness. Every bit of empty space is blue lines, pink margins...

Margins! That's it. The world you're in is rendered on notebook paper. Objects are flat, paperlike, outlined in waxy lines. You look down at your hands and suppress a cry of shock. You're wearing a triangular smock of purple and your body is composed of black lines. You unfurl your fingers and watch as the lines retract and relax.

You take in the rest of your surroundings. You seem to be in a playground of sorts. There's a set of swings and a playstructure in a garish primary colours. In the distance is a forest, the paper trees swaying in the wind. One of the trees stands proudly in the center, a broken ladder propped against it.

>go to closet
Closet
The closet is small and cramped, with a suitcase in the corner. It's dimly lit, and you can smell a faint musty odor, as if the space hasn't been opened in years. The walls are lined with old, forgotten coats, and the ceiling is low, making the space feel claustrophobic.

You can see a suitcase (closed) and a keypad here.

>go to treehouse
Treehouse
You have entered a cozy treehouse. It has a wooden floor, a small table with some board games, a hammock, and a small girl around the age of 6. There's a window with a view of the forest below.

The girl is doodling furiously. It's some sort of composition of flowers. Every now and then she pauses to wipe her wax-covered hands on her skirt. When she sees you, she cries out in delight.

"I see you managed to fix the ladder," she says. I was getting bored up here. What took you so long?"

>go to plushieland
Plushieland
You wake up in world of cotton. Everything you see is rendered in a shade of pastel - the turgid river, the sky, the meadows in front of you. You reach out a hand, tentatively. The cotton is soft.

Before you are a medley of anthropomorphic plushies. You spot a jubjub, hedgehog, and even a djungelskog. A girl around the age of seven is playing with the stuffed animals.

To the north you see a yellow schoolhouse. To the south there is a vibrant meadow.

You can see a jubjub, a hedgehog and a djungelskog here.

>x river
A turgid river, made of fluffy blue transparent cotton.

>n
Schoolhouse
Yellow brick.

* * *

>help
 Here are some instructions to get you started:
 • Use "look" to observe your surroundings.
 • Use "take item" or "take all" to pick up items.
 • Use "inventory" or "i" to see what you're carrying.
 • Use "go direction" to move around (e.g., "go north" or simply "n" or "s").
 • For more details, try interacting with objects using "examine item" or "x item".
 • Visit: https://tinyurl.com/inform-cheatsheet for more commands.

>x poster
A relic of your emo era. The corners have frayed over the years.

>pull string
You pull the string, and the lightbulb flickers to life.

>about
This is a little demo of an interactive fiction game about dream journals and imaginary worlds. Please be patient as we work through any bugs ૮ ․ ․ ྀིა.

>x newsprint
You straighten out the sheet of newspaper, handling it delicately. You can't quite make out the words. Your head is spinning.

>pull string
You pull the string, and the lightbulb goes dark.

>take newsprint
Taken.

>s
Closet
The closet is small and cramped, with a suitcase in the corner. It's dimly lit, and you can smell a faint musty odor, as if the space hasn't been opened in years. The walls are lined with old, forgotten coats, and the ceiling is low, making the space feel claustrophobic.

You can see a suitcase (closed) and a keypad here.

>n
Bedroom
 .   \_/       .:"    .:"    .:"
 -=(_)=- /\ ||    /\||    /\||
 .   / \     //\\|   //\\|   //\\|
 .          //  \\  //  \\  //  \\
 .         //    \ ^/    \^/    \\
 .         |  ( )  ||  ( ) || ( ) |
 .         |       ||      ||      |%
 &%&--==--&%-==--%&

Your bedroom is unadorned. The walls are chalky and the ground bare. The only decoration is a poster of The Killers. A lightbulb hangs from the ceiling. A tiny window is opened a crack, and the sound of faint static comes through. A crumpled newsprint lies in the wastebin, forgotten.

In the corner your monitor blinks wearily. You must've forgotten to turn it off.  Beside you is a worn out drawer. To the north your kitchen fridge hums. To the south is a cramped closet.

>n
Kitchen
Your kitchen has seen better days. A fridge lies in one corner. Near the door is a row of plants with yellowing leaves.

You can see a jug, a plant, a note, a baking soda and a fridge (closed) here.

>open fridge
The fridge is empty except for a tub of baking soda and a piece of candy. The candy beckons to you.

>x baking soda
Off-brand Great Value. Good for neutralizing odours.

>eat candy
(first taking the candy)
You pocket the candy. It feels heavy, like nostalgia.

You unwrap the candy and pop it in your mouth. It tastes of a strange medley of flavours-vanilla custard, citrus, a hint of buttered toast. Delightful.

A sudden prickling rips through your throat, like you've swallowed something you shouldn't have. You double over, coughing, clutching the counter for balance. There's something lodged in your throat.

Clang! Out comes a small piece of metal. You pick it up, bewildered. It's a small key.

You can press i to view your inventory.

>i
You are carrying:
  a silver key
  a newsprint

>x key
A stainless steel key, slightly bigger than your thumb. It's wet with your saliva.

* * *

>l
Bedroom
 .   \_/       .:"    .:"    .:"
 -=(_)=- /\ ||    /\||    /\||
 .   / \     //\\|   //\\|   //\\|
 .          //  \\  //  \\  //  \\
 .         //    \ ^/    \^/    \\
 .         |  ( )  ||  ( ) || ( ) |
 .         |       ||      ||      |%
 &%&--==--&%-==--%&

Your bedroom is unadorned. The walls are chalky and the ground bare. The only decoration is a poster of The Killers. A lightbulb hangs from the ceiling. A tiny window is opened a crack, and the sound of faint static comes through. To the south your kitchen fridge hums.

In the corner your monitor blinks wearily. You must've forgotten to turn it off.  Beside you is a worn out drawer. To the north is a cramped closet.

>x drawer
It's covered with a layer of dust and lined with faint scratches. You can make out a tiny keyhole in the upper right corner.

>x keyhole
You can't see any such thing.

>l closet
You can't see any such thing.

>x closet
You can't see any such thing.

>go to closet
Closet
It's empty except for a single cardbord box. You feel cramped.

You can see a cardboard box (closed) here.

>l
Closet
It's empty except for a single cardbord box. You feel cramped.

You can see a cardboard box (closed) here.

* * *

>x monitor
A yellowing Windows XP that's seen better days. 

The computer is currently switched off.

>use computer
That's not a verb I recognise.

>turn computer on
The monitor lights up.

You switch the computer on.

>l
Bedroom
 .   \_/       .:"    .:"    .:"
 -=(_)=- /\ ||    /\||    /\||
 .   / \     //\\|   //\\|   //\\|
 .          //  \\  //  \\  //  \\
 .         //    \ ^/    \^/    \\
 .         |  ( )  ||  ( ) || ( ) |
 .         |       ||      ||      |%
 &%&--==--&%-==--%&

Your bedroom is unadorned. The walls are chalky and the ground bare. The only decoration is a poster of The Killers. A lightbulb hangs from the ceiling. A tiny window is opened a crack, and the sound of faint static comes through. To the south your kitchen fridge hums.

In the corner your monitor blinks wearily. You must've forgotten to turn it off.  Beside you is a worn out drawer. To the north is a cramped closet.

>turn monitor on
That's already on.

>x drawer
It's covered with a layer of dust and lined with faint scratches. You can make out a tiny keyhole in the upper right corner.

>L
Bedroom
 .   \_/       .:"    .:"    .:"
 -=(_)=- /\ ||    /\||    /\||
 .   / \     //\\|   //\\|   //\\|
 .          //  \\  //  \\  //  \\
 .         //    \ ^/    \^/    \\
 .         |  ( )  ||  ( ) || ( ) |
 .         |       ||      ||      |%
 &%&--==--&%-==--%&

Your bedroom is unadorned. The walls are chalky and the ground bare. The only decoration is a poster of The Killers. A lightbulb hangs from the ceiling. A tiny window is opened a crack, and the sound of faint static comes through. To the south your kitchen fridge hums.

In the corner your monitor blinks wearily. You must've forgotten to turn it off.  Beside you is a worn out drawer. To the north is a cramped closet.

>x poster
A relic of your emo era. The corners have frayed over the years.

>x light
A single lightbulb. A string dangles.

The lightbulb is currently switched off.

>x string
You can't see any such thing.

>l
Bedroom
 .   \_/       .:"    .:"    .:"
 -=(_)=- /\ ||    /\||    /\||
 .   / \     //\\|   //\\|   //\\|
 .          //  \\  //  \\  //  \\
 .         //    \ ^/    \^/    \\
 .         |  ( )  ||  ( ) || ( ) |
 .         |       ||      ||      |%
 &%&--==--&%-==--%&

Your bedroom is unadorned. The walls are chalky and the ground bare. The only decoration is a poster of The Killers. A lightbulb hangs from the ceiling. A tiny window is opened a crack, and the sound of faint static comes through. To the south your kitchen fridge hums.

In the corner your monitor blinks wearily. You must've forgotten to turn it off.  Beside you is a worn out drawer. To the north is a cramped closet.

>go north
Closet
The closet is small and cramped, with a single cardboard box in the corner. It's dimly lit, and you can smell a faint musty odor, as if the space hasn't been opened in years. The walls are lined with old, forgotten coats, and the ceiling is low, making the space feel claustrophobic.

You can see a cardboard box (closed) here.

>open box
Inside is a yearbook, a record player, a binder, and a 3D printed narwhal, amongst other odds and ends.
The closet smells dusty.

>x box
In the cardboard box are a yearbook, record player and narwhal.

>l
Closet
The closet is small and cramped, with a single cardboard box in the corner. It's dimly lit, and you can smell a faint musty odor, as if the space hasn't been opened in years. The walls are lined with old, forgotten coats, and the ceiling is low, making the space feel claustrophobic.

You can see a cardboard box (in which are a yearbook (empty), record player and narwhal) here.

>x yearbook
 ??? ???? ???? ???? You can't make out the text right now..

* * *

>x record player
A vintage turntable. It's loaded with a vinyl - Best of 2010s Hits.

Record player is currently switched off.

>x narwhal
An old hurt vibrates through you. You can't place why.

>take
(the cardboard box)
Taken.

>take all
There are none at all available!

>i
You are carrying:
  a cardboard box (open)
    a yearbook (open but empty)
    record player
    narwhal

* * *

>leave emma
You feel like you're being sucked out of this world. You feel a whirlwind of crying, of pain, of grief, of everything crashing down on you in that moment. When the whirling stops you find yourself in your bedroom. Wake up.

Bedroom
 .   \_/       .:"    .:"    .:"
 -=(_)=- /\ ||    /\||    /\||
 .   / \     //\\|   //\\|   //\\|
 .          //  \\  //  \\  //  \\
 .         //    \ ^/    \^/    \\
 .         |  ( )  ||  ( ) || ( ) |
 .         |       ||      ||      |%
 &%&--==--&%-==--%&

Your bedroom is unadorned. The walls are chalky and the ground bare. The only decoration is a poster of The Killers. A lightbulb hangs from the ceiling. A tiny window is opened a crack, and the sound of faint static comes through. In the distance your kitchen fridge hums.

In the corner your monitor blinks wearily. You must've forgotten to turn it off.  Beside you is a worn out drawer. To the left is a cramped closet.

>check out the drawer
I only understood you as far as wanting to check outside.

>look at the lightbulb
A single lightbulb. A string dangles.

The lightbulb is currently switched off.

>turn on the lightbulb
You pull on the lightbulb. Things seem a little brighter.

You switch the lightbulb on.

>look around
You can't see any such thing.

>look at the window
You can't see any such thing.

>look at drawer
It's covered with a layer of dust and lined with faint scratches. You can make out a tiny keyhole in the upper right corner.

>open the drawer
It seems to be locked.

>look at the closet
You can't see any such thing.

>look at closet
You can't see any such thing.

>go to closet
Closet
It's empty except for a single cardbord box. You feel cramped.

You can see a cardboard box (closed) here.

>open the cardboard box
Inside is a yearbook, a record player, a binder, and a 3D printed narwhal, amongst other odds and ends.
The closet smells dusty.

>open the yearbook
That's already open.

>look at the yearbook
 ¯¯̿̿¯̿̿"̿̿̿̿̿̿̿"̿̿"̿̿̿̿̿"̿̿̿)͇̿̿)̿̿̿̿ "̿̿̿̿̿̿\̵͇̿̿\=(•̪̀●́)=o/̵͇̿̿/"̿̿ ̿ ̿̿ .

>x yearbook
 ¯¯̿̿¯̿̿"̿̿̿̿̿̿̿"̿̿"̿̿̿̿̿"̿̿̿)͇̿̿)̿̿̿̿ "̿̿̿̿̿̿\̵͇̿̿\=(•̪̀●́)=o/̵͇̿̿/"̿̿ ̿ ̿̿ .

>x record
A vintage turntable. It's loaded with a vinyl - Best of 2010s Hits.

Record player is currently switched off.

>turn on record
You switch record player on.

Phoebe Bridgers fills the room.

>open binder
You can't see any such thing.

>x binder
You can't see any such thing.

>x narwhal
An old hurt vibrates through you. You can't place why.

>x box
In the cardboard box are a yearbook, record player and narwhal.

Twenty One Pilots fills the room.

>go to bedroom
Bedroom
 .   \_/       .:"    .:"    .:"
 -=(_)=- /\ ||    /\||    /\||
 .   / \     //\\|   //\\|   //\\|
 .          //  \\  //  \\  //  \\
 .         //    \ ^/    \^/    \\
 .         |  ( )  ||  ( ) || ( ) |
 .         |       ||      ||      |%
 &%&--==--&%-==--%&

Your bedroom is unadorned. The walls are chalky and the ground bare. The only decoration is a poster of The Killers. A lightbulb hangs from the ceiling. A tiny window is opened a crack, and the sound of faint static comes through. In the distance your kitchen fridge hums.

In the corner your monitor blinks wearily. You must've forgotten to turn it off.  Beside you is a worn out drawer. To the left is a cramped closet.

>x killers
You can't see any such thing.

>x poster
A relic of your emo era. The corners have frayed over the years.

>take killers
You can't see any such thing.

>go to kitchen
Kitchen
Your kitchen has seen better days. A fridge lies in one corner. Near the door is a row of plants with yellowing leaves. At the north corner is a door that leads onto the street.

You can see a note and a fridge (closed) here.

>x fridge
You're bizarrely attached to your fridge. It's charming in its age, rickedy, humming in a contented manner. It's covered with  and a note is pinned to it.

>x note
There's a note stuck to the fridge. It reads  ¯¯̿̿¯̿̿"̿̿̿̿̿̿̿"̿̿"̿̿̿̿̿"̿̿̿)͇̿̿)̿̿̿̿ "̿̿̿̿̿̿\̵͇̿̿\=(•̪̀●́)=o/̵͇̿̿/"̿̿ ̿ ̿̿ ."

>take note
That's fixed in place.

>x plants
You can't see any such thing.

>water plants
That's not a verb I recognise.

>open fridge
The fridge contains ?????? ??? ?? ????? ??????? ??????? ?? ????
 and curiously, a piece of candy. The candy beckons to you.

>take candy
You pocket the candy. It feels heavy, like nostalgia.

* * *

>eat candy
You unwrap the candy and pop it in your mouth. It tastes of a strange medley of flavours - vanilla custard, citrus, a hint of buttered toast. Delightful.

A sudden prickling rips through your throat, like you've swallowed something you shouldn't have. You double over, coughing, clutching the counter for balance. There's something lodged in your throat.

Clang! Out comes a small piece of metal. You pick it up, bewildered. It's a small key.

>go to bedroom
Bedroom
 .   \_/       .:"    .:"    .:"
 -=(_)=- /\ ||    /\||    /\||
 .   / \     //\\|   //\\|   //\\|
 .          //  \\  //  \\  //  \\
 .         //    \ ^/    \^/    \\
 .         |  ( )  ||  ( ) || ( ) |
 .         |       ||      ||      |%
 &%&--==--&%-==--%&

You step into the bedroom and are flooded with emotion. Every inch of its surface now looks as if it's been dipped in iridescence. The walls are pulsating and warm, shifting from blue to red to violet. The scent of lilacs fill the air.  In the distance your kitchen fridge hums.

Lo-fi indie is playing from your computer. You notice movement on the screen. Beside you is a worn out drawer. To the left is a cramped closet.

>i
You are carrying:
  a silver key

>x drawer
It's covered with a layer of dust and lined with faint scratches. You can make out a tiny keyhole in the upper right corner.

>open drawer
It seems to be locked.

>open drawer with key
You unlock the drawer.

>x drawer
It's covered with a layer of dust and lined with faint scratches. You can make out a tiny keyhole in the upper right corner.

>open drawer
You pull open the drawer. A journal, a box of crayons, and a pair of glasses  lies inside. The journal beckons to you.

>take journal
Taken. A worn out journal in which you've taken to scrawling your dreams.

>take crayons
Taken. A bright yellow box. On it are instructions on how to draw certain shapes: a bunny, a lion, a narwhal, and a unicorn.

>take glasses
Taken. You see nothing special about glasses.

>draw a narwhal
You can't see any such thing.

>draw on journal
You can't see any such thing.

>read journal
You flip the pages randomly and arrive at page 3:

A thunderous crack cuts through the air. Everything begins to spin. You watch as everything around you dissolves and reforms until your eyes begin to burn from the distortion. 3. "??????"

Toybox (Dreamland)
 |                  /^\   / -- )
 |                 / | \ (____/
 |                / | | \ / /
 |               /_|_|_|_/ /
 |                |     / /
 | __    __    __ |    / /__    __    __
 |  |__|  |__|  |.   / /|  |__|  |__|  |
 |__            ____/ /___           __|
 |          / .------  )         |
 |         / /        /          |  TOYBOX
 |        / /        /           |
 ~~~~~~~~~~~~-----------~~~~~~~~

You open your eyes to pure whiteness. Every bit of empty space is blue lines, pink margins...

Margins! That's it. The world you're in is rendered on notebook paper. Objects are flat, paperlike, outlined in waxy lines. You look down at your hands and suppress a cry of shock. You're wearing a triangular smock of purple and your body is composed of black lines. You unfurl your fingers and watch as the lines retract and relax.

You take in the rest of your surroundings. You seem to be in a playground of sorts. There's a set of swings and a playstructure in a garish primary colours. In the distance is a forest, the paper trees swaying in the wind.

A girl no older than five is playing in the field. She's crawling through the grass, plucking out a stem here and there.

>x girl
The girl is wearing a red checkered dress. Her hair is in knotted and face streaked with mud. Her ankle is red and swelling.

>x angle
You can't see any such thing.

>x ankle
You can't see any such thing.

>x grass
You can't see any such thing.

>x swing
You can't see any such thing.

>x playstructure
You can't see any such thing.

>talk to girl
That's not a verb I recognise.

>say hi
(to Emma)
Emma doesn't seem to hear you. She seems lost in a daydream.

>say hi again
(to Emma)
Emma is humming to herself.

>say hi once more
(to Emma)
Emma is too busy digging through the meadow.

>hi emma
That's not a verb I recognise.

>hang with emma
That's not a verb I recognise.

>ask emma to draw narwhal
Emma is too busy digging through the meadow.

>dig with emma
That's not a verb I recognise.

>talk to emma
That's not a verb I recognise.

>ask emma questions
Emma doesn't seem to hear you. She seems lost in a daydream.

>how are you doing emma
That's not a verb I recognise.

>ask emma what she is digging for
Emma doesn't seem to hear you. She seems lost in a daydream.

>give emma crayons
Emma doesn't seem interested.

>i
You are carrying:
  glasses
  crayons
  a journal (closed)
  a silver key

>give emma journal
Emma doesn't seem interested.

>ask emma about crayons
Emma is humming to herself.

>ask emma about name
Emma is too busy digging through the meadow.

* * *

>w
Kitchen
Your kitchen has seen better days. A fridge lies in one corner. Near the door is a row of plants with yellowing leaves. At the north corner is a door that leads onto the street.

You can see a note and a fridge (closed) here.

>open fridge
The fridge contains ?????? ??? ?? ????? ??????? ??????? ?? ????
 and curiously, a piece of candy. The candy beckons to you.

* * *

>eat candy
(first taking the candy)
You pocket the candy. It feels heavy, like nostalgia.

You unwrap the candy and pop it in your mouth. It tastes of a strange medley of flavours - vanilla custard, citrus, a hint of buttered toast. Delightful.

A sudden prickling rips through your throat, like you've swallowed something you shouldn't have. You double over, coughing, clutching the counter for balance. There's something lodged in your throat.

Clang! Out comes a small piece of metal. You pick it up, bewildered. It's a small key.

>e
Bedroom
 .   \_/       .:"    .:"    .:"
 -=(_)=- /\ ||    /\||    /\||
 .   / \     //\\|   //\\|   //\\|
 .          //  \\  //  \\  //  \\
 .         //    \ ^/    \^/    \\
 .         |  ( )  ||  ( ) || ( ) |
 .         |       ||      ||      |%
 &%&--==--&%-==--%&

You step into the bedroom and are flooded with emotion. Every inch of its surface now looks as if it's been dipped in iridescence. The walls are pulsating and warm, shifting from blue to red to violet. The scent of lilacs fill the air.  In the distance your kitchen fridge hums.

Lo-fi indie is playing from your computer. You notice movement on the screen. Beside you is a worn out drawer. To the left is a cramped closet.

>unlock drawer with key
You unlock the drawer.

>open drawer
You pull open the drawer. A journal, a box of crayons, and a pair of glasses lies inside. The journal beckons to you.

>take all
newsprint: Taken. You straighten out the sheet of newspaper, handling it delicately.  The page contains two girls playing in a sandbox. The smaller of the two is labouring over a crudely formed sand sculpture. The other is carelessly sprawled across the sand, her body covered in dust. You study the small stature, the neat braids, the wrinkled clothing. They look around preschool age. 

¯¯̿̿¯̿̿"̿̿̿̿̿̿̿"̿̿"̿̿̿̿̿"̿̿̿)͇̿̿)̿̿̿̿ "̿̿̿̿̿̿\̵͇̿̿\=(•̪̀●́)=o/̵͇̿̿/. You can't make out the caption.

journal: Taken. A worn out journal in which you've taken to scrawling your dreams.

crayons: Taken. A bright yellow box. On it are instructions on how to draw certain shapes: a bunny, a lion, a narwhal, and a unicorn.

glasses: Taken. You see nothing special about glasses.

>read journal
You flip the pages randomly and arrive at page 2:

A thunderous crack cuts through the air. Everything begins to spin. You watch as everything around you dissolves and reforms until your eyes begin to burn from the distortion. 2. "???????"

Toybox (Dreamland)
You open your eyes to pure whiteness. Every bit of empty space is blue lines, pink margins...

Margins! That's it. The world you're in is rendered on notebook paper. Objects are flat, paperlike, outlined in waxy lines. You look down at your hands and suppress a cry of shock. Your dress is a triangle, your body composed of black lines. Everything is rendered crudely, as though by the hand of a child. Trees sway, paper thin, a cluster of green scribbles. Nearby, red and blue scribbles hint at flowers. In the distance you spot a spiral shaped sun with pulsating lines.

A girl no older than five is playing in the meadow. She's crawling through the grass, plucking out a stem here and there.

>draw bunny with crayons
I only understood you as far as wanting to draw the bunny.

>i
You are carrying:
  glasses
  crayons
  a journal (closed)
  a newsprint
  a silver key

>draw bunny with crayonsgregr
I only understood you as far as wanting to draw the bunny.

>i
You are carrying:
  glasses
  crayons
  a journal (closed)
  a newsprint
  a silver key

>draw bunny
(with the crayons) You doodle a bunny. Looks cute. Something drops in your pocket.

>i
You are carrying:
  a bunny
  glasses
  crayons
  a journal (closed)
  a newsprint
  a silver key

>x dreamland
You can't see any such thing.

>x toybox
You can't see any such thing.

>draw clover
(with the crayons) You doodle a clover. Looks cute. Something drops in your pocket.

>draw clover
(with the crayons) You doodle a clover. Looks cute. Something drops in your pocket.

>i
You are carrying:
  a clover
  a bunny
  glasses
  crayons
  a journal (closed)
  a newsprint
  a silver key

>give emma clover
Emma doesn't seem interested.

>tell emma hi
Emma doesn't seem to hear you. She seems lost in a daydream.

>e
You can't go that way.

>give emma fdfivoijo
You can't see any such thing.

>drop crayons
Dropped.

>draw bunny with crayonsgregr
I only understood you as far as wanting to draw the bunny.

>draw bunny
You don't have anything to draw with.

>take crayons
Taken.

>draw bunny
(with the crayons) You doodle a bunny. Looks cute. Something drops in your pocket.

>draw dandelion
(with the crayons) You doodle a dandelion. Looks cute. Something drops in your pocket.

>give dandelion to emma
Emma looks up at you in wonder. "A dandelion", she whispers reverentially. "I've never seen one before."

You tell her they're commonplace where you're from. "That can't be right," she says. "My grandma says they went extinct long ago. They were killed, you know. For being too resilient. Her eyes water. "C'mon! Let's wish together."

You play along as she counts down. On one you both blow, and your breaths mingle with the spores as they take off into the air. You stare at this strange girl, twirling the empty stem in her hands. She seems much older than her five years."

* * *

>look
Bedroom
 \_/       .:"    .:"    .:"
 -=(_)=- /\||   /\||   /\||
 .    / \   //\\|  //\\| //\\|
 .          //  \\ //  \\ //  \\
 .         //    \^/    \^/    \\
 .          |  ( ).     ( )      ( )
 .     &|  | %   ||        |  ||  |%
 &%&--==--&%-==--%&

Your bedroom is unadorned. The walls are chalky and the ground bare. The only decoration is a poster of The Killers. A collection of empty plastic water bottles are scattered across the floor. A lightbulb hangs from the ceiling. A tiny window is opened a crack, and the sound of faint static comes through. In the distance your kitchen fridge hums.

Beside you is a worn out nightstand with a drawer. It's covered with a layer of dust and lined with faint scratches. To the left is a cramped closet.

Your computer monitor blinks wearily. You must've forgotten to turn it off. The low hum of the fan grates on you.

On the desk are a ballpoint pen and a computer.

A crumpled newsprint lies wrinkled on the floor.

* * *

>look at flyer
The flyer displays an image of a man intertwined with a female robot. Distantly, you recall the cashier at CyberSpace handing it to you when you purchased your new speakers.

>look at computer
A yellowing Windows XP that's seen better days.

>x
What do you want to examine?

>l
Bedroom
Your bedroom is unadorned. Nearby your kitchen light remains on.

Over in the corner your computer monitor blinks wearily. You must've forgotten to turn it off.

An flyer lies wrinkled on the floor.

>go west
Kitchen
Your kitchen has seen better days. A fridge lies in one corner.

The old fridge hums irratically.

Ruby smiles at you.

>open fridge
You open the fridge, revealing an apple.

>eat apple
(first taking the apple)
You eat the apple. Not bad.

>talk to ruby
That's not a verb I recognise.

>kiss ruby
Ruby isn't programmed to do that yet.

* * *

>look at poster
A relic of your emo era. The corners have frayed over the years.

>go to kitchen
Kitchen
Your kitchen has seen better days. A fridge lies in one corner. Near the door is a row of plants with yellowing leaves. At the north corner is a door that leads onto the street.

You can see a note and a fridge (closed) here.

>look at note
There's a note stuck to the fridge. It reads  ¯¯̿̿¯̿̿"̿̿̿̿̿̿̿"̿̿"̿̿̿̿̿"̿̿̿)͇̿̿)̿̿̿̿ "̿̿̿̿̿̿\̵͇̿̿\=(•̪̀●́)=o/̵͇̿̿/"̿̿ ̿ ̿̿ ."

>open fridge
The fridge contains ?????? ??? ?? ????? ??????? ??????? ?? ????
 and curiously, a piece of candy. The candy beckons to you.

* * *

>open drawe
You can't see any such thing.

* * *

>open drawer
It seems to be locked.

>unlock drawer with key
You unlock the drawer.

* * *

>open drawer
You pull open the drawer. A journal, a box of crayons, and a pair of glasses lies inside. The journal beckons to you.

>take crayons
Taken. A bright yellow box. On it are instructions on how to draw certain shapes: a bunny, a lion, a narwhal, and a unicorn.

>open journal
You open the journal.

>read journal
You're not reading anything.

>take journal
Taken. A worn out journal in which you've taken to scrawling your dreams.

>read journal
You flip the pages randomly and arrive at page 1:

A thunderous crack cuts through the air. Everything begins to spin. You watch as everything around you dissolves and reforms until your eyes begin to burn from the distortion. 1. "TOYBOX"

Toybox Dreamland

>say hi to girl
You can't see any such thing.

>ask emma about world
You can't see any such thing.

>ask emma about what she’s doing
You can't see any such thing.

>ask emma about meadow
You can't see any such thing.

>ask emma about wish
You can't see any such thing.

>draw clover with crayons
(with the crayons) You doodle a clover with crayons. Looks cute.

>draw clover
(with the crayons) You doodle a clover. Looks cute.

>draw smile
(with the crayons) You doodle a smile. Looks cute.

>draw
What do you want to draw?

>drop crayons
Dropped.

>draw smile
You don't have anything to draw with.

>open fridge
You can't see any such thing.

>take crayons
Taken.

>i
You are carrying:
  crayons
  a journal (open but empty)
  a silver key

>draw bunny
(with the crayons) You doodle a bunny. Looks cute.

>i
You are carrying:
  crayons
  a journal (open but empty)
  a silver key

* * *

>look at poster
A relic of your emo era. The corners have frayed over the years.

>look at water bottles
That noun did not make sense in this context.

>look at nightstand
That noun did not make sense in this context.

>look at computer
 

The computer is currently switched off.

>turn on computer
The monitor lights up.

You switch the computer on.

>look at screen
That noun did not make sense in this context.

>x computer
A yellowing Windows XP that's seen better days. Last night's League of Legends match history stares you right in the face. 

The computer is currently switched on.

>x computer
A yellowing Windows XP that's seen better days. Last night's League of Legends match history stares you right in the face. 

The computer is currently switched on.

>smell fridge
You can't see any such thing.

>go to fridge
That noun did not make sense in this context.

>go to kitchen
Kitchen
Your kitchen has seen better days. A fridge lies in one corner. Near the door is a row of plants with yellowing leaves. At the north corner is a door that leads onto the street.

The fridge hums irratically. Your stomach growls.

>eat food
You can't see any such thing.

>open fridge
The fridge contains ?????? ??? ?? ????? ??????? ??????? ?? ????
 and curiously, an apple. The apple beckons to you.

>eat apple
(first taking the apple)
A strange warmth washes over you. Things start to look funny. Something falls in your pocket.

>i
You are carrying:
  a tiny steel key

>look at key
A stainless steel key, slightly bigger than your thumb.

>eat key
That's plainly inedible.

>look at apple
That noun did not make sense in this context.

>look at fridge
There's a note stuck to the fridge. It reads  "Come play me in Dreamland /( ^^)/."

In the fridge are a black vial, a 'Drink Me' potion, shortcake and crackers.

>eat crackers
That's plainly inedible.

>eat shortcake
That's plainly inedible.

>drink potion
There's nothing suitable to drink here.

>look at potiomn
That noun did not make sense in this context.

>look at potion
You see nothing special about the 'Drink Me' potion.

>look at crackers
You see nothing special about crackers.

>look at fridge
There's a note stuck to the fridge. It reads  "Come play me in Dreamland /( ^^)/."

In the fridge are a black vial, a 'Drink Me' potion, shortcake and crackers.

>go to room
That noun did not make sense in this context.

>go to bedroom
Bedroom
You step into the bedroom and are flooded with emotion. Every inch of its surface now looks as if it's been dipped in iridescence. The walls are pulsating and warm, shifting from blue to red to violet. The scent of lilacs fill the air.  In the distance your kitchen fridge hums.

Beside you is a worn out nightstand with a drawer. It's covered with a layer of dust and lined with faint scratches. To the left is a cramped closet.

Lo-fi indie is playing from your computer. You notice movement on the screen.

On the desk are a ballpoint pen and a computer.

A crumpled newsprint lies wrinkled on the floor.

>look at nesprint
That noun did not make sense in this context.

>look at newsprint
You straighten out the sheet of newspaper, handling it delicately.  The page contains two girls playing in a sandbox. The smaller of the two is labouring over a crudely formed sand sculpture. The other is occupied with making careful sand angels, her body covered in a layer of grime. You study the stature, the neat braids, the wrinkled clothing. They appear to be around preschool age. 

¯¯̿̿¯̿̿"̿̿̿̿̿̿̿"̿̿"̿̿̿̿̿"̿̿̿)͇̿̿)̿̿̿̿ "̿̿̿̿̿̿\̵͇̿̿\=(•̪̀●́)=o/̵͇̿̿/. You can't make out the caption.

>look at newsprint
You straighten out the sheet of newspaper, handling it delicately.  The page contains two girls playing in a sandbox. The smaller of the two is labouring over a crudely formed sand sculpture. The other is occupied with making careful sand angels, her body covered in a layer of grime. You study the stature, the neat braids, the wrinkled clothing. They appear to be around preschool age. 

¯¯̿̿¯̿̿"̿̿̿̿̿̿̿"̿̿"̿̿̿̿̿"̿̿̿)͇̿̿)̿̿̿̿ "̿̿̿̿̿̿\̵͇̿̿\=(•̪̀●́)=o/̵͇̿̿/. You can't make out the caption.

>eat newsprint
That's plainly inedible.

>take newsprint
Taken.

>take apple
You can't see any such thing.

>take fridge
You can't see any such thing.

>go to kitchen
Kitchen
Your kitchen has seen better days. A fridge lies in one corner. Near the door is a row of plants with yellowing leaves. At the north corner is a door that leads onto the street.

The fridge hums irratically. Your stomach growls.

>take fridge
Taken.

>i]
That's not a verb I recognise.

>i
You are carrying:
  a fridge (open)
    a black vial
    a 'Drink Me' potion
    shortcake
    crackers
  a newsprint
  a tiny steel key

>go to bedroom
Bedroom
You step into the bedroom and are flooded with emotion. Every inch of its surface now looks as if it's been dipped in iridescence. The walls are pulsating and warm, shifting from blue to red to violet. The scent of lilacs fill the air.  In the distance your kitchen fridge hums.

Beside you is a worn out nightstand with a drawer. It's covered with a layer of dust and lined with faint scratches. To the left is a cramped closet.

Lo-fi indie is playing from your computer. You notice movement on the screen.

On the desk are a ballpoint pen and a computer.

>go go tox nightstand
That noun did not make sense in this context.

>x nightstand
That noun did not make sense in this context.

>x drawer
You see nothing special about the drawer.

>open drawer
You pull open the drawer. A journal, a box of crayons, and a housekey lies inside.

>take hournal
You can't see any such thing.

>take crayons
Taken.

>take housekey
Taken.

>take all
journal: Taken.
ballpoint pen: Taken.

>i
You are carrying:
  a ballpoint pen
  a journal (closed and locked)
  a housekey
  crayons
  a fridge (open)
    a black vial
    a 'Drink Me' potion
    shortcake
    crackers
  a newsprint
  a tiny steel key

>drop
What do you want to drop?

>drop all
ballpoint pen: Dropped.
journal: Dropped.
housekey: Dropped.
crayons: Dropped.
fridge: Dropped.
newsprint: Dropped.
tiny steel key: Dropped.

>i
You are carrying nothing.

>take all
tiny steel key: Taken.
newsprint: Taken.
fridge: Taken.
crayons: Taken.
housekey: Taken.
journal: Taken.
ballpoint pen: Taken.
black vial: Taken.
'Drink Me' potion: Taken.
shortcake: Taken.
crackers: Taken.

>drop all
crackers: Dropped.
shortcake: Dropped.
'Drink Me' potion: Dropped.
black vial: Dropped.
ballpoint pen: Dropped.
journal: Dropped.
housekey: Dropped.
crayons: Dropped.
fridge: Dropped.
newsprint: Dropped.
tiny steel key: Dropped.

>go to bedroom
Bedroom
You step into the bedroom and are flooded with emotion. Every inch of its surface now looks as if it's been dipped in iridescence. The walls are pulsating and warm, shifting from blue to red to violet. The scent of lilacs fill the air.  In the distance your kitchen fridge hums.

Beside you is a worn out nightstand with a drawer. It's covered with a layer of dust and lined with faint scratches. To the left is a cramped closet.

Lo-fi indie is playing from your computer. You notice movement on the screen.

On the desk is a computer.

You can also see a tiny steel key, a newsprint, a fridge (empty), crayons, a housekey, a journal (closed), a ballpoint pen, a black vial, a 'Drink Me' potion, shortcake and crackers here.

>go to closer
That noun did not make sense in this context.

>go to closet
Closet
It's empty except for a single cardbord box. You feel cramped.

You can see a cardboard box (closed) here.

>eat box
That's plainly inedible.

>open box
Inside is a yearbook, a record player, a binder, and a 3D printed narwhal, amongst other odds and ends.
The closet smells dusty.

>take all
cardboard box: Taken.
yearbook: Taken.
record player: Taken.
narwhal: Taken.

>open yearbook
That's already open.

>x yearbook
Class of XXYZ.

>drop yearbook
Dropped.

>open record player
It isn't something you can open.

>x record player
Music sounds better on vinyl

Record player is currently switched off.

>pllay record player
That's not a verb I recognise.

>turn on record player
You switch record player on.

Phoebe Bridgers fills the room.

>drop record player
Dropped.

Fall Out Boy fills the room.

>open journal
You can't see any such thing.

>i
You are carrying:
  narwhal
  a cardboard box (open but empty)

Twenty One Pilots fills the room.

>take journal
You can't see any such thing.

>go to bedroom
Bedroom
You step into the bedroom and are flooded with emotion. Every inch of its surface now looks as if it's been dipped in iridescence. The walls are pulsating and warm, shifting from blue to red to violet. The scent of lilacs fill the air.  In the distance your kitchen fridge hums.

Beside you is a worn out nightstand with a drawer. It's covered with a layer of dust and lined with faint scratches. To the left is a cramped closet.

Lo-fi indie is playing from your computer. You notice movement on the screen.

On the desk is a computer.

You can also see a tiny steel key, a newsprint, a fridge (empty), crayons, a housekey, a journal (closed), a ballpoint pen, a black vial, a 'Drink Me' potion, shortcake and crackers here.

Fall Out Boy fills the room.

>take hournal
You can't see any such thing.

>take journal
Taken.

Twenty One Pilots fills the room.

>open journal
It seems to be locked.

>open journal with key
(first taking the tiny steel key)
That doesn't seem to fit the lock.

>unlock journal with key
That doesn't seem to fit the lock.

>l
Bedroom
You step into the bedroom and are flooded with emotion. Every inch of its surface now looks as if it's been dipped in iridescence. The walls are pulsating and warm, shifting from blue to red to violet. The scent of lilacs fill the air.  In the distance your kitchen fridge hums.

Beside you is a worn out nightstand with a drawer. It's covered with a layer of dust and lined with faint scratches. To the left is a cramped closet.

Lo-fi indie is playing from your computer. You notice movement on the screen.

On the desk is a computer.

You can also see a newsprint, a fridge (empty), crayons, a housekey, a ballpoint pen, a black vial, a 'Drink Me' potion, shortcake and crackers here.

Twice fills the room.

>l
Bedroom
You step into the bedroom and are flooded with emotion. Every inch of its surface now looks as if it's been dipped in iridescence. The walls are pulsating and warm, shifting from blue to red to violet. The scent of lilacs fill the air.  In the distance your kitchen fridge hums.

Beside you is a worn out nightstand with a drawer. It's covered with a layer of dust and lined with faint scratches. To the left is a cramped closet.

Lo-fi indie is playing from your computer. You notice movement on the screen.

On the desk is a computer.

You can also see a newsprint, a fridge (empty), crayons, a housekey, a ballpoint pen, a black vial, a 'Drink Me' potion, shortcake and crackers here.

I beg your pardon?

>x
What do you want to examine?

>x
What do you want to examine?

>l
Bedroom
You step into the bedroom and are flooded with emotion. Every inch of its surface now looks as if it's been dipped in iridescence. The walls are pulsating and warm, shifting from blue to red to violet. The scent of lilacs fill the air.  In the distance your kitchen fridge hums.

Beside you is a worn out nightstand with a drawer. It's covered with a layer of dust and lined with faint scratches. To the left is a cramped closet.

Lo-fi indie is playing from your computer. You notice movement on the screen.

On the desk is a computer.

You can also see a newsprint, a fridge (empty), crayons, a housekey, a ballpoint pen, a black vial, a 'Drink Me' potion, shortcake and crackers here.

>look
Bedroom
You step into the bedroom and are flooded with emotion. Every inch of its surface now looks as if it's been dipped in iridescence. The walls are pulsating and warm, shifting from blue to red to violet. The scent of lilacs fill the air.  In the distance your kitchen fridge hums.

Beside you is a worn out nightstand with a drawer. It's covered with a layer of dust and lined with faint scratches. To the left is a cramped closet.

Lo-fi indie is playing from your computer. You notice movement on the screen.

On the desk is a computer.

You can also see a newsprint, a fridge (empty), crayons, a housekey, a ballpoint pen, a black vial, a 'Drink Me' potion, shortcake and crackers here.

>look around
You must supply a noun.

Bruno Mars fills the room. You're on the verge of tears, but you're not sure why.

* * *

>look at room
You can't see any such thing.

>look at bedroom
You can't see any such thing.

>look around
You can't see any such thing.

>look at poster
A relic of your emo era. The corners have frayed over the years.

>look at lightbulb
A single lightbulb. A string dangles.

The lightbulb is currently switched off.

>turn on lightbub
You can't see any such thing.

>turn on lightbulb
You pull on the lightbulb. Things seem a little brighter.

You switch the lightbulb on.

>go to kitchen
Kitchen
Your kitchen has seen better days. A fridge lies in one corner. Near the door is a row of plants with yellowing leaves. At the north corner is a door that leads onto the street.

You can see a note and a fridge (closed) here.

* * *

>look at note
There's a note stuck to the fridge. It reads  ¯¯̿̿¯̿̿"̿̿̿̿̿̿̿"̿̿"̿̿̿̿̿"̿̿̿)͇̿̿)̿̿̿̿ "̿̿̿̿̿̿\̵͇̿̿\=(•̪̀●́)=o/̵͇̿̿/"̿̿ ̿ ̿̿ ."

>look at fridge
You're bizarrely attached to your fridge. It's charming in its age, rickedy, humming in a contented manner. It's covered with  and a note is pinned to it.

>look at plant
You can't see any such thing.

>open fridge
The fridge contains ?????? ??? ?? ????? ??????? ??????? ?? ????
 and curiously, a piece of candy. The candy beckons to you.

* * *

>i
You are carrying:
  a silver key

>go to bedroom
Bedroom
 .   \_/       .:"    .:"    .:"
 -=(_)=- /\ ||    /\||    /\||
 .   / \     //\\|   //\\|   //\\|
 .          //  \\  //  \\  //  \\
 .         //    \ ^/    \^/    \\
 .         |  ( )  ||  ( ) || ( ) |
 .         |       ||      ||      |%
 &%&--==--&%-==--%&

You step into the bedroom and are flooded with emotion. Every inch of its surface now looks as if it's been dipped in iridescence. The walls are pulsating and warm, shifting from blue to red to violet. The scent of lilacs fill the air.  In the distance your kitchen fridge hums.

Lo-fi indie is playing from your computer. You notice movement on the screen. Beside you is a worn out drawer. To the left is a cramped closet.

>look at computer
A yellowing Windows XP that's seen better days. 

The computer is currently switched off.

>turn on computer
The monitor lights up.

You switch the computer on.

>look at computer
Your screen is being populated with a barrage of popups. The same message is written on them. "Your dreams await. \( ^^)/". 

The computer is currently switched on.

>look at closet
You can't see any such thing.

>look at drawer
It's covered with a layer of dust and lined with faint scratches. You can make out a tiny keyhole in the upper right corner.

>open drawer
It seems to be locked.

>unlock drawer
(with the silver key)
You unlock the drawer.

>look inside drawer
You can't see inside, since the drawer is closed.

>open drawer
You pull open the drawer. A journal, a box of crayons, and a pair of glasses  lies inside. The journal beckons to you.

>read journal
You're not reading anything.

* * *

>take journal
Taken. A worn out journal in which you've taken to scrawling your dreams.

>take all
crayons: Taken. A bright yellow box. On it are instructions on how to draw certain shapes: a bunny, a lion, a narwhal, and a unicorn.

glasses: Taken. A wacky looking pair of with black frames and blue-purple swirling lenses. On the side are the words  Sentence Scrambler.

>put on glasses
You put on glasses.

>read journal
You flip the pages randomly and arrive at page 1:

A thunderous crack cuts through the air. Everything begins to spin. You watch as everything around you dissolves and reforms until your eyes begin to burn from the distortion. 1. "TOYBOX"

Toybox (Dreamland)
 |                  /^\   / -- )
 |                 / | \ (____/
 |                / | | \ / /
 |               /_|_|_|_/ /
 |                |     / /
 | __    __    __ |    / /__    __    __
 |  |__|  |__|  |.   / /|  |__|  |__|  |
 |__            ____/ /___           __|
 |          / .------  )         |
 |         / /        /          |  TOYBOX
 |        / /        /           |
 ~~~~~~~~~~~~-----------~~~~~~~~

You open your eyes to pure whiteness. Every bit of empty space is blue lines, pink margins...

Margins! That's it. The world you're in is rendered on notebook paper. Objects are flat, paperlike, outlined in waxy lines. You look down at your hands and suppress a cry of shock. You're wearing a triangular smock of purple and your body is composed of black lines. You unfurl your fingers and watch as the lines retract and relax.

You take in the rest of your surroundings. You seem to be in a playground of sorts. There's a set of swings and a playstructure in a garish primary colours. In the distance is a forest, the paper trees swaying in the wind.

A girl no older than five is playing in the field. She's crawling through the grass, plucking out a stem here and there.

* * *

>say hi to girl
She crushes you in a hug. You found me!

>say yes i found you to girl
Emma doesn't seem to hear you. She seems lost in a daydream.

>hug emma
Emma turns bright red. Whadya doing?

>push emma
Emma might not like that.

>kick emma
That's not a verb I recognise.

>say emma to emma
She brightens. That's me!

>ask emma who am i
Emma is humming to herself.

>ask emma where am i
Emma is too busy digging through the meadow.

>ask emma where
Emma doesn't seem to hear you. She seems lost in a daydream.

>where
That's not a verb I recognise.

>ask emma toybox
Emma doesn't seem to hear you. She seems lost in a daydream.

>say toybox
(to Emma)
Emma doesn't seem to hear you. She seems lost in a daydream.

>ask emma what she is doing
Emma doesn't seem to hear you. She seems lost in a daydream.

>ask emma grass
Emma looks solemn, "I'm looking for something. It's a special plant. My grandma told me it's got special powers, and I need it to make a wish.

>i
You are carrying:
  glasses (being worn)
  crayons
  a journal (closed)
  a silver key

>look in field
You can't see any such thing.

>look at field
You can't see any such thing.

>ask special plant
You can't see any such thing.

>ask emma special plant
Emma is humming to herself.

>ask emma plant
Emma is humming to herself.

>ask emma wish
You feel it too, don't you? whispers Emma. This is a magic place.

>ask emma powers
Emma doesn't seem to hear you. She seems lost in a daydream.

>ask emma about wish
You feel it too, don't you? whispers Emma. This is a magic place.

>ask emma about making a wish
Emma is humming to herself.

* * *

>open drawer
You pull open the drawer. A journal, a box of crayons, and a housekey lies inside.

>open nightstand
You pull open the drawer. A book, a box of crayons, and a housekey lies inside.

>take all
newsprint: Taken.
book: Taken.
crayons: Taken.
housekey: Taken.
ballpoint pen: Taken.

>draw on book
I didn't understand that sentence.

>draw on book
I didn't understand that sentence.

>draw
I didn't understand that sentence.

>draw N
I didn't understand that sentence.

>draw on book
I didn't understand that sentence.

>on
That's not a verb I recognise.

>bunny
That's not a verb I recognise.

>write on book
You can't see any such thing.

>draw
I didn't understand that sentence.

* * *

>s
Closet
The closet is small and cramped, with a suitcase in the corner. It's dimly lit, and you can smell a faint musty odor, as if the space hasn't been opened in years. The walls are lined with old, forgotten coats, and the ceiling is low, making the space feel claustrophobic.

You can see a suitcase (closed) and a keypad here.

* * *

>open fridge
The fridge is empty except for a tub of baking soda and a piece of candy. The candy beckons to you.

>eat candy
(first taking the candy)
You pocket the candy. It feels heavy, like nostalgia.

You unwrap the candy and pop it in your mouth. It tastes of a strange medley of flavours-vanilla custard, citrus, a hint of buttered toast. Delightful.

A sudden prickling rips through your throat, like you've swallowed something you shouldn't have. You double over, coughing, clutching the counter for balance. There's something lodged in your throat.

Clang! Out comes a small piece of metal. You pick it up, bewildered. It's a small key.

You can press i to view your inventory.

>i
You are carrying:
  a silver key

* * *

>open drawer
It seems to be locked.

>unlock drawer
(with the silver key)
The drawer yawns open lazily. In it are a journal, crayons and glasses.

>take all
newsprint: Taken. You straighten out the sheet of newspaper, handling it delicately.  The page contains two girls playing in a sandbox. The smaller of the two is labouring over a crudely formed sand sculpture. The other is carelessly sprawled across the sand, her body covered in dust. You study the small stature, the neat braids, the wrinkled clothing. They look around preschool age. 

¯¯̿̿¯̿̿"̿̿̿̿̿̿̿"̿̿"̿̿̿̿̿"̿̿̿)͇̿̿)̿̿̿̿ "̿̿̿̿̿̿\̵͇̿̿\=(•̪̀●́)=o/̵͇̿̿/. You can't make out the caption.

journal: Taken. A worn out journal in which you've taken to scrawling your dreams.

TABLE OF CONTENTS:
 0. BEDROOM 
 1.  TOYBOX
 2.  ?????
 3. ?????

You can read the journal by typing: read page N of journal.

crayons: Taken. A bright yellow box. On it are instructions on how to draw certain shapes: a bunny, a lion, a narwhal, and a unicorn. Good for fixing things, if you're in the right place.

To draw something with the crayons, type: draw `object` with crayons.

glasses: Taken. A wacky looking pair of with black frames and blue-purple swirling lenses. On the side are the words  Sentence Scrambler.

>read journal
You need to specify a page to read.

>read page 1 of journal
A thunderous crack cuts through the air. Everything begins to spin. You watch as everything around you dissolves and reforms until your eyes begin to burn from the distortion.

Toybox (Dreamland)
 |                  /\   
 |                 / | \ 
 |                / | | \ 
 |               /_|_|_|_
 |                |     / /
 |__    __    __ |    / /__    __    __
 |  |__|  |__|  |.   / /|  |__|  |__|  |
 |__            ____/ /___           __|
 |          / .------  )         |
 |         / /        /          |  TOYBOX
 |        / /        /           |
 ~~~~~~~~~~~~-----------~~~~~~~~

You open your eyes to pure whiteness. Every bit of empty space is blue lines, pink margins...

Margins! That's it. The world you're in is rendered on notebook paper. Objects are flat, paperlike, outlined in waxy lines. You look down at your hands and suppress a cry of shock. You're wearing a triangular smock of purple and your body is composed of black lines. You unfurl your fingers and watch as the lines retract and relax.

You take in the rest of your surroundings. You seem to be in a playground of sorts. There's a set of swings and a playstructure in a garish primary colours. In the distance is a forest, the paper trees swaying in the wind. One of the trees stands proudly in the center, a broken ladder propped against it.

>s
You can't go that way.

>l
Toybox (Dreamland)
 |                  /\   
 |                 / | \ 
 |                / | | \ 
 |               /_|_|_|_
 |                |     / /
 |__    __    __ |    / /__    __    __
 |  |__|  |__|  |.   / /|  |__|  |__|  |
 |__            ____/ /___           __|
 |          / .------  )         |
 |         / /        /          |  TOYBOX
 |        / /        /           |
 ~~~~~~~~~~~~-----------~~~~~~~~

You open your eyes to pure whiteness. Every bit of empty space is blue lines, pink margins...

Margins! That's it. The world you're in is rendered on notebook paper. Objects are flat, paperlike, outlined in waxy lines. You look down at your hands and suppress a cry of shock. You're wearing a triangular smock of purple and your body is composed of black lines. You unfurl your fingers and watch as the lines retract and relax.

You take in the rest of your surroundings. You seem to be in a playground of sorts. There's a set of swings and a playstructure in a garish primary colours. In the distance is a forest, the paper trees swaying in the wind. One of the trees stands proudly in the center, a broken ladder propped against it.

>draw ladder
What do you want to draw with?

>draw ladder with crayons
You color in the missing gaps with the silver crayon. Good as new.

>draw on ladder with crayons
You have already fixed the ladder.

>climb
What do you want to climb?

>climb ladder
You grip the edges of the ladder cautiously, and hoist yourself up. Half of you expects the scribbled lines to give way, but they hold steady. After a few minutes of climbing, you are met with a trapdoor. You push on the latch.

Treehouse
You have entered a cozy treehouse. It has a wooden floor, a small table with some board games, a hammock, and a small girl around the age of 6. There's a window with a view of the forest below.

The girl is doodling furiously. It's some sort of composition of flowers. Every now and then she pauses to wipe her wax-covered hands on her skirt. When she sees you, she cries out in delight.

"I see you managed to fix the ladder," she says. I was getting bored up here. What took you so long?"

>x girl
A small girl wearing a checkered dress. Her hair is in neat plaits and her socks are mismatched. She looks familiar. 

You can interact with Emma by typing "ask Emma about topic". The topic should be a single word.

>draw dandelion
What do you want to draw with?

>draw dandelion with crayons
You use the crayons to carefully draw a bright yellow dandelion. The petals are vivid, and the stem is a bright green. The drawing looks almost alive.

The air sizzles, and with a pop, something drops in your pocket.

>give dandelion to emma
Emma looks up at you in wonder. "A dandelion", she whispers reverentially. "I've never seen one before."

You tell her they're commonplace where you're from. "That can't be right," she says. "My grandma says they went extinct long ago. They were killed, you know. For being too resilient." She cups the fluffy white thing delicately. "C'mon! Let's wish together."

You put your heads together and your breaths create a flurry of white as the spores release into the air. You stare at this strange girl, wide-eyed with awe, twirling the empty stem in her hands. You're drawn to her uncomplicated joy.

"I can't tell you what I wished for," she says peevishly, as if anticipating your next question. "Cause then it won't come true! But I do want to see you again. It gets lonely here, you know".

She gazes at you in wonder. "I've never had a friend. Will you be my friend?

> Befriend Emma? Y/N

>n
Emma deflates for just a second. Then she shrugs it off, and says, "That's okay! Just let me know if you change your mind ^_^.

>give dandelion to emma
Emma looks up at you in wonder. "A dandelion", she whispers reverentially. "I've never seen one before."

You tell her they're commonplace where you're from. "That can't be right," she says. "My grandma says they went extinct long ago. They were killed, you know. For being too resilient." She cups the fluffy white thing delicately. "C'mon! Let's wish together."

You put your heads together and your breaths create a flurry of white as the spores release into the air. You stare at this strange girl, wide-eyed with awe, twirling the empty stem in her hands. You're drawn to her uncomplicated joy.

"I can't tell you what I wished for," she says peevishly, as if anticipating your next question. "Cause then it won't come true! But I do want to see you again. It gets lonely here, you know".

She gazes at you in wonder. "I've never had a friend. Will you be my friend?

> Befriend Emma? Y/N

>y
Her face blooms with delight. "YAAAAY", she cries. "We can all be friends now. Me, you, Mr. Narkins.

Her face darkens for a second. "Have you seen him, by the way? He's a sea unicorn." You feel suction around you, like you're going through a vacuum. Everything blurs.

Bedroom
 .   \_/       .:"    .:"    .:"
 -=(_)=- /\ ||    /\||    /\||
 .   / \     //\\|   //\\|   //\\|
 .          //  \\  //  \\  //  \\
 .         //    \ ^/    \^/    \\
 .         |  ( )  ||  ( ) || ( ) |
 .         |       ||      ||      |%
 &%&--==--&%-==--%&

It's weird to see things in 3D now. Your room has gone back to normal. There's an odd humming coming from your computer, though. 

 Beside you is a worn out drawer. To the north your kitchen fridge hums. To the south is a cramped closet.

>s
Closet
The closet is small and cramped, with a suitcase in the corner. It's dimly lit, and you can smell a faint musty odor, as if the space hasn't been opened in years. The walls are lined with old, forgotten coats, and the ceiling is low, making the space feel claustrophobic.

You can see a suitcase (closed) and a keypad here.

>unlock suitcase
What do you want to unlock the suitcase with?

>x keypad
A numeric keypad, a little old fashioned. The tag reads "My favourite neopet".

>open suitcase
> This suitcase requires a passcode:

>f
The suitcase beeps. The passcode is incorrect.

>x suitcase
 A small black suitcase and a keypad on the side. It looks like it requires a passcode to open. 

You can enter a passcode by typing "open suitcase".

>open suitcase
> This suitcase requires a passcode:

>jubjub
The suitcase clicks open. Inside the suitcase is a collection of random objects, a yearbook, a record player, and a narwhal

>take all
yearbook: Taken. .

narwhal: It's a ragged thing. An old hurt vibrates through you. You can't place why. From faraway, the journal vibrates.

>x journal
A worn out journal in which you've taken to scrawling your dreams.

TABLE OF CONTENTS:
 0. BEDROOM 
 1.  TOYBOX
 2.  PLUSHIELAND
 3. ?????

You can read the journal by typing: read page N of journal.

>read page 2 of journal
A thunderous crack cuts through the air. Everything begins to spin. You watch as everything around you dissolves and reforms until your eyes begin to burn from the distortion.

Plushieland
You wake up in world of cotton. Everything you see is rendered in a shade of pastel - the turgid river, the sky, the meadows in front of you. You reach out a hand, tentatively. The cotton is soft.

Before you are a medley of anthropomorphic plushies. You spot a jubjub, hedgehog, and even a djungelskog. A girl around the age of seven is playing with the stuffed animals.

To the north you see a yellow schoolhouse. To the south there is a vibrant meadow.

You can see Emma, a jubjub, a hedgehog and a djungelskog here.

>talk to jubjub
"Oh, hello," whispers the jubjub. "I'd like to stay and chat, but I'm in the middle of one of Illusen's quests."

>ask jubjub
What do you want to ask the jubjub for?

>x jubjub
A bright red jubjub. It's pacing around in tight circles, vibrating with nervous energy.

You can interact with the jubjub by typing "ask jubjub about topic". The topic should be a single word.

>x jubjub
A bright red jubjub. It's pacing around in tight circles, vibrating with nervous energy.

You can interact with the jubjub by typing "ask jubjub about topic". The topic should be a single word.

>ask jubjub about illusen
"You haven't seen Illusen's spell book, have you?" asks the jubjub. "It should be nestled somewhere in the Schoolhouse Library..."

>talk to jubjub
"Oh, hello," whispers the jubjub. "I'd like to stay and chat, but I'm in the middle of one of Illusen's quests."

>ask jubjub about hi
"Oh, hello," whispers the jubjub. "I'd like to stay and chat, but I'm in the middle of one of Illusen's quests."

>go to schoolhouse
Schoolhouse
A small schoolhouse atop a grassy hill, red walls delineated with thick, playful strokes. The roof is cozily off-kilter a bell perched on top. A crooked wooden sign near the door reads "Neoschool" in swirling letters. Curled on the front steps are a couple of petpets. To the north is a meadow. To the east is a Library.

>help
 Here are some instructions to get you started:
 • look to observe your surroundings
 • examine item or x item to look at any object
 • take item or take all to pick up items
 • go to room to teleport to a specified room
 • inventory or i to see what you're carrying
 • go direction to move around (e.g., go north  or simply n  or s)
 • https://tinyurl.com/inform-cheatsheet for more commands.

>e
Library
Tall bookshelves line the walls, filled with texts on Neopian lore. A sturdy oak desk sits in the center, where the librarian watches over her collection.

The librarian is a wise-looking Aisha with spectacles perched on her nose. She greets you with a knowing smile.

Beside her is a book titled Floral Encyclopedia. Perhaps it holds a clue.

>talk to librarian
The librarian adjusts her spectacles and gives you a knowing smile. "If you wish to take out a book, you must first provide an offering of knowledge. Bring me something that demonstrates your wisdom, and then we shall talk."

>read Floral Encyclopedia
The book describes three flowers:
 - The Starpetal Bloom, which glows faintly in the moonlight.
 - The Mindroot Blossom, said to enhance memory and wisdom.
 - The Dewshade Lily, known for its calming properties.

>go to meadow
Meadow
A lush, open field filled with vibrant flowers. The air is thick with the scent of wild blooms.

You can see a Starpetal Bloom, a Mindroot Blossom and a Dewshade Lily here.

>take mindroot blossom
You carefully pluck the Mindroot Blossom, hoping it is the one the librarian seeks.

>go to library
Library
Tall bookshelves line the walls, filled with texts on Neopian lore. A sturdy oak desk sits in the center, where the librarian watches over her collection.

The librarian is a wise-looking Aisha with spectacles perched on her nose. She greets you with a knowing smile.

Beside her is a book titled Floral Encyclopedia. Perhaps it holds a clue.

>give mindroot blossom to librarian
The librarian inspects the flower and nods. "Well done. You have proven your wisdom. Here is the book you seek." She hands you Illusen's Spell Book.

>i
You are carrying:
  Illusen's Spell Book
  a Mindroot Blossom
  narwhal
  a yearbook (open but empty)
  a crayola key
  a dandelion
  glasses
  crayons
  a journal (closed)
  a newsprint
  a silver key

* * *

>eat candy
(first taking the candy)
You pocket the candy. It feels heavy, like nostalgia.

You unwrap the candy and pop it in your mouth. It tastes of a strange medley of flavours-vanilla custard, citrus, a hint of buttered toast. Delightful.

A sudden prickling rips through your throat, like you've swallowed something you shouldn't have. You double over, coughing, clutching the counter for balance. There's something lodged in your throat.

Clang! Out comes a small piece of metal. You pick it up, bewildered. It's a small key.

You can press i to view your inventory.

>n
You can't go that way.

* * *

>open drawer with key
The drawer yawns open lazily. In it are a journal, crayons and glasses.

>take all
journal: Taken. A worn out journal in which you've taken to scrawling your dreams.

TABLE OF CONTENTS:
 1.  TOYBOX
 2.  ?????
 3. ?????

You can read the journal by typing: read page N of journal.

crayons: Taken. A bright yellow box. On it are instructions on how to draw certain shapes: a bunny, a lion, a narwhal, and a unicorn. Good for fixing things, if you're in the right place.

glasses: Taken. A wacky looking pair of with black frames and blue-purple swirling lenses. On the side are the words  Sentence Scrambler.

>wear glasses
You put on glasses.

>s
Closet
The closet is small and cramped, with a single cardboard box in the corner. It's dimly lit, and you can smell a faint musty odor, as if the space hasn't been opened in years. The walls are lined with old, forgotten coats, and the ceiling is low, making the space feel claustrophobic.

You can see a suitcase (closed) and a keypad here.

>n
Bedroom
 .   \_/       .:"    .:"    .:"
 -=(_)=- /\ ||    /\||    /\||
 .   / \     //\\|   //\\|   //\\|
 .          //  \\  //  \\  //  \\
 .         //    \ ^/    \^/    \\
 .         |  ( )  ||  ( ) || ( ) |
 .         |       ||      ||      |%
 &%&--==--&%-==--%&

You step into the bedroom and are flooded with emotion. Every inch of its surface now looks as if it's been dipped in. The walls are pulsating and warm, shifting from blue to red to violet. 

Lo-fi indie is playing from your computer. You notice movement on the screen. Beside you is a worn out drawer. To the north your kitchen fridge hums. To the south is a cramped closet.

* * *

>n
Kitchen
Your kitchen has seen better days. A fridge lies in one corner. Near the door is a row of plants with yellowing leaves.

You can see a jug, a plant, a note and a fridge (empty) here.

>x note
There's a note stuck to the fridge. It reads  "Where did you go? Come play with me in Dreamland /( ^^)/."

>x
What do you want to examine?

>n
You see nothing unexpected in that direction.

>s
Bedroom
 .   \_/       .:"    .:"    .:"
 -=(_)=- /\ ||    /\||    /\||
 .   / \     //\\|   //\\|   //\\|
 .          //  \\  //  \\  //  \\
 .         //    \ ^/    \^/    \\
 .         |  ( )  ||  ( ) || ( ) |
 .         |       ||      ||      |%
 &%&--==--&%-==--%&

You step into the bedroom and are flooded with emotion. Every inch of its surface now looks as if it's been dipped in. The walls are pulsating and warm, shifting from blue to red to violet. 

Lo-fi indie is playing from your computer. You notice movement on the screen. Beside you is a worn out drawer. To the north your kitchen fridge hums. To the south is a cramped closet.

>s
Closet
The closet is small and cramped, with a single cardboard box in the corner. It's dimly lit, and you can smell a faint musty odor, as if the space hasn't been opened in years. The walls are lined with old, forgotten coats, and the ceiling is low, making the space feel claustrophobic.

You can see a suitcase (closed) and a keypad here.

>s
You can't go that way.

>n
Bedroom
 .   \_/       .:"    .:"    .:"
 -=(_)=- /\ ||    /\||    /\||
 .   / \     //\\|   //\\|   //\\|
 .          //  \\  //  \\  //  \\
 .         //    \ ^/    \^/    \\
 .         |  ( )  ||  ( ) || ( ) |
 .         |       ||      ||      |%
 &%&--==--&%-==--%&

You step into the bedroom and are flooded with emotion. Every inch of its surface now looks as if it's been dipped in. The walls are pulsating and warm, shifting from blue to red to violet. 

Lo-fi indie is playing from your computer. You notice movement on the screen. Beside you is a worn out drawer. To the north your kitchen fridge hums. To the south is a cramped closet.

* * *

>n
Kitchen
Your kitchen has seen better days. A fridge lies in one corner. Near the door is a row of plants with yellowing leaves.

You can see a jug, a plant, a note and a fridge (empty) here.

>open fridge
That's already open.

>s
Bedroom
 .   \_/       .:"    .:"    .:"
 -=(_)=- /\ ||    /\||    /\||
 .   / \     //\\|   //\\|   //\\|
 .          //  \\  //  \\  //  \\
 .         //    \ ^/    \^/    \\
 .         |  ( )  ||  ( ) || ( ) |
 .         |       ||      ||      |%
 &%&--==--&%-==--%&

You step into the bedroom and are flooded with emotion. Every inch of its surface now looks as if it's been dipped in. The walls are pulsating and warm, shifting from blue to red to violet. 

Lo-fi indie is playing from your computer. You notice movement on the screen. Beside you is a worn out drawer. To the north your kitchen fridge hums. To the south is a cramped closet.

>read journal
You need to specify a page to read.

>x journal
A worn out journal in which you've taken to scrawling your dreams.

TABLE OF CONTENTS:
 1.  TOYBOX
 2.  ?????
 3. ?????

You can read the journal by typing: read page N of journal.

>read page 1 of journal
A thunderous crack cuts through the air. Everything begins to spin. You watch as everything around you dissolves and reforms until your eyes begin to burn from the distortion.

Toybox (Dreamland)
 |                  /\   
 |                 / | \ 
 |                / | | \ 
 |               /_|_|_|_
 |                |     / /
 |__    __    __ |    / /__    __    __
 |  |__|  |__|  |.   / /|  |__|  |__|  |
 |__            ____/ /___           __|
 |          / .------  )         |
 |         / /        /          |  TOYBOX
 |        / /        /           |
 ~~~~~~~~~~~~-----------~~~~~~~~

You open your eyes to pure whiteness. Every bit of empty space is blue lines, pink margins...

Margins! That's it. The world you're in is rendered on notebook paper. Objects are flat, paperlike, outlined in waxy lines. You look down at your hands and suppress a cry of shock. You're wearing a triangular smock of purple and your body is composed of black lines. You unfurl your fingers and watch as the lines retract and relax.

You take in the rest of your surroundings. You seem to be in a playground of sorts. There's a set of swings and a playstructure in a garish primary colours. In the distance is a forest, the paper trees swaying in the wind. One of the trees stands proudly in the center, a broken ladder propped against it.

>x tree
A knotted looking thing with a thick trunk. Leaning on it is a worn out ladder. Nestled in the branches is a winding structure, a treehouse of sorts.

>x swings
A rusted thing. Doesn't look safe to swing on.

>x playstructure
Warped plastics. Doesn't look safe to visit.

>x forest
You can't see any such thing.

>x trees
You can't see any such thing.

>x tree
A knotted looking thing with a thick trunk. Leaning on it is a worn out ladder. Nestled in the branches is a winding structure, a treehouse of sorts.

>x ladder
The ladder leans against the tree, but some of its rungs are missing.

>draw on ladder with crayons
You color in the missing gaps with the silver crayon. Good as new.

>climb ladder
You climb the ladder.

Treehouse
You have entered a cozy treehouse. It has a wooden floor, a small table with some board games, a hammock, and a small girl around the age of 6. There's a window with a view of the forest below.

The girl is doodling furiously. It's some sort of composition of flowers. Every moment she pauses to wipe her wax-covered hands on her skirt. When she sees you, she cries out in delight.

"I see you managed to fix the ladder," she says. I was getting bored up here. What took you so long?"

>x girl
A small girl wearing a checkered dress. Her hair is in neat plaits and her socks are mismatched. She looks familiar. 

You can interact with her by typing: ask girl about `topic`. The topic should be a singular word.

>ask girl about name
Huuuh? I'm Emma, silly. Did you hit your head on the way down here?

>ask girl about dress
Emma doesn't seem to hear you. She seems lost in a daydream.

>ask girl about dress
Emma is too busy doodling flowers.

>ask girl about flower
Emma is humming to herself.

>ask girl about flowers
Emma brightens up. "Yes! I'm trying to draw a specific flower... for a wish. It's yellow, and then not yellow. When it's old it becomes a puffball."

>ask girl about dandelion
Emma looks up at you in wonder. So you do know the story! Could'ya help me find one? Pretty please!

>draw dandelion with crayons
You use the crayons to carefully draw a bright yellow dandelion. The petals are vivid, and the stem is a bright green. The drawing looks almost alive.

The air sizzles, and with a pop, something drops in your pocket

* * *

>give dandelion
That's not a valid response.

>give emma dandelion
Emma looks up at you in wonder. "A dandelion", she whispers reverentially. "I've never seen one before."

You tell her they're commonplace where you're from. "That can't be right," she says. "My grandma says they went extinct long ago. They were killed, you know. For being too resilient. She cups the fluffy white thing delicately. "C'mon! Let's wish together."

You put your heads together and your breaths create a flurry of white as the spores release into the air. You stare at this strange girl, wide-eyed with awe, twirling the empty stem in her hands. You're drawn to her uncomplicated joy.

"I wished for a friend," she says abruptly. She gazes at you in wonder. "I've never had a friend. Will you be my friend?

> Befriend Emma? Y/N

>i
That's not a valid response.

>give emma dandelion
Emma looks up at you in wonder. "A dandelion", she whispers reverentially. "I've never seen one before."

You tell her they're commonplace where you're from. "That can't be right," she says. "My grandma says they went extinct long ago. They were killed, you know. For being too resilient. She cups the fluffy white thing delicately. "C'mon! Let's wish together."

You put your heads together and your breaths create a flurry of white as the spores release into the air. You stare at this strange girl, wide-eyed with awe, twirling the empty stem in her hands. You're drawn to her uncomplicated joy.

"I wished for a friend," she says abruptly. She gazes at you in wonder. "I've never had a friend. Will you be my friend?

> Befriend Emma? Y/N

>y
Her face blooms with delight. "YAAAAY", she cries. "We can all be friends now. Me, you, Mr. Narkins.

Her face darkens for a second. "Have you seen him, by the way? He's a sea unicorn." You feel suction around you, like you're going through a vacuum. Everything blurs.

Bedroom
 .   \_/       .:"    .:"    .:"
 -=(_)=- /\ ||    /\||    /\||
 .   / \     //\\|   //\\|   //\\|
 .          //  \\  //  \\  //  \\
 .         //    \ ^/    \^/    \\
 .         |  ( )  ||  ( ) || ( ) |
 .         |       ||      ||      |%
 &%&--==--&%-==--%&

 It's weird to see things in 3D now. Your room has gone back to normal. There's an odd humming coming from your computer, though. 

 Beside you is a worn out drawer. To the north your kitchen fridge hums. To the south is a cramped closet.

>n
Kitchen
Your kitchen has seen better days. A fridge lies in one corner. Near the door is a row of plants with yellowing leaves.

You can see a jug, a plant, a note and a fridge (empty) here.

>f
That's not a verb I recognise.

>y
That was a rhetorical question.

>s
Bedroom
 .   \_/       .:"    .:"    .:"
 -=(_)=- /\ ||    /\||    /\||
 .   / \     //\\|   //\\|   //\\|
 .          //  \\  //  \\  //  \\
 .         //    \ ^/    \^/    \\
 .         |  ( )  ||  ( ) || ( ) |
 .         |       ||      ||      |%
 &%&--==--&%-==--%&

 It's weird to see things in 3D now. Your room has gone back to normal. There's an odd humming coming from your computer, though. 

 Beside you is a worn out drawer. To the north your kitchen fridge hums. To the south is a cramped closet.

>x computer
A yellowing Windows XP that's seen better days. 

The computer is currently switched off.

The browser is open to your email inbox. You have 5 unread emails. You can select an email to read by typing a number from 1 to 5 or type `exit` to leave.

> Select an email to read:

>1
From: Art Class Reminder - Reminder: Bring Your Crayons to Art Class!

This is a reminder to bring your crayons to art class next week. We'll be doing a special drawing activity.

> Select an email to read:

* * *

>n
Kitchen
Your kitchen has seen better days. A fridge lies in one corner. Near the door is a row of plants with yellowing leaves.

You can see a jug, a plant, a note and a fridge (empty) here.

>s
Bedroom
 .   \_/       .:"    .:"    .:"
 -=(_)=- /\ ||    /\||    /\||
 .   / \     //\\|   //\\|   //\\|
 .          //  \\  //  \\  //  \\
 .         //    \ ^/    \^/    \\
 .         |  ( )  ||  ( ) || ( ) |
 .         |       ||      ||      |%
 &%&--==--&%-==--%&

 It's weird to see things in 3D now. Your room has gone back to normal. There's an odd humming coming from your computer, though. 

 Beside you is a worn out drawer. To the north your kitchen fridge hums. To the south is a cramped closet.

>s
Closet
The closet is small and cramped, with a single cardboard box in the corner. It's dimly lit, and you can smell a faint musty odor, as if the space hasn't been opened in years. The walls are lined with old, forgotten coats, and the ceiling is low, making the space feel claustrophobic.

You can see a suitcase (closed) and a keypad here.

>open closet
You can't see any such thing.

>open suitcase
> This suitcase requires a passcode:

* * *

>jubjub
The suitcase clicks open. Inside the suitcase is a collection of random objects, a yearbook, a record player, and a narwhal

>x record player
A vintage turntable. It's loaded with a vinyl - Best of 2010s Hits.

Record player is currently switched off.

* * *

>turn on record player
You switch record player on.

Phoebe Bridgers fills the room.

>x yearbook
Class of XXYZ.

BETWEEN FRIENDS fills the room.

>x yearbook
Class of XXYZ.

BETWEEN FRIENDS fills the room.

>open yearbook
That's already open.

Porter Robinson fills the room. You're on the verge of tears, but you're not sure why.

>x narwhal
A ragged thing. An old hurt vibrates through you. You can't place why.

Pussy Riot fills the room.

>take all
yearbook: Taken.
narwhal: It's a ragged thing. An old hurt vibrates through you. You can't place why. From faraway, the journal vibrates.

BETWEEN FRIENDS fills the room.

>read journal
You need to specify a page to read.

BETWEEN FRIENDS fills the room.

>x journal
A worn out journal in which you've taken to scrawling your dreams.

TABLE OF CONTENTS:
 1.  TOYBOX
 2.  PLUSHIELAND
 3. ?????

You can read the journal by typing: read page N of journal.

BETWEEN FRIENDS fills the room.

>read page 2 of journal
A thunderous crack cuts through the air. Everything begins to spin. You watch as everything around you dissolves and reforms until your eyes begin to burn from the distortion. 2. "PLUSHIELAND"

Plushieland
You wake up in world of cotton. Everything you see is rendered in a shade of pastel - the turgid river, the sky, the meadows in front of you. Before you are a medley of anthropomorphic plushies. You spot a jubjub, hedgehog, and even a djungelskog. A girl around the age of seven is playing with the stuffed animals.

You can see Emma here.

>x emma
 Emma looks bigger than you remember. She's fiddling with a sewing needle.

You can interact with her by typing: ask Emma about `topic`. The topic should be a singular word.

>ask girl about narwhal
"Mr. Narkins!" she cries.

>give narwhal to emma
"Mr. Narkins!" she cries. "You've returned him to me. But his wings are gone...". She sobers up. "That's to be continued. This is a demo, after all."

    *** You've reached the end of the demo (´｡• ᵕ •｡`) ♡ See you again soon. ***

Would you like to RESTART, RESTORE a saved game, QUIT or UNDO the last command?

>undo
Plushieland
[Previous turn undone.]

>help
Welcome to the game! Here are some instructions to get you started: å- Use "look" to observe your surroundings. - Use "take item" to pick up items. - Use "inventory" to see what you're carrying. - Use "go direction" to move around (e.g., "go north" or simply "north"). - For more details, try interacting with objects using "examine item".

* * *

>s
Closet
The closet is small and cramped, with a suitcase in the corner. It's dimly lit, and you can smell a faint musty odor, as if the space hasn't been opened in years. The walls are lined with old, forgotten coats, and the ceiling is low, making the space feel claustrophobic.

You can see a suitcase (closed) and a keypad here.

>open fridge
The fridge contains a jug and a piece of candy. The candy beckons to you.

* * *

>eat candy
(first taking the candy)
You pocket the candy. It feels heavy, like nostalgia.

You unwrap the candy and pop it in your mouth. It tastes of a strange medley of flavours - vanilla custard, citrus, a hint of buttered toast. Delightful.

A sudden prickling rips through your throat, like you've swallowed something you shouldn't have. You double over, coughing, clutching the counter for balance. There's something lodged in your throat.

Clang! Out comes a small piece of metal. You pick it up, bewildered. It's a small key.

>take jug
Taken. You see nothing special about the jug.

>water plant
You water the plant with the jug. The plant perks up a little.

>x plant
You see nothing special about the plant.

>s
You can't go that way.

>n
Bedroom
 .   \_/       .:"    .:"    .:"
 -=(_)=- /\ ||    /\||    /\||
 .   / \     //\\|   //\\|   //\\|
 .          //  \\  //  \\  //  \\
 .         //    \ ^/    \^/    \\
 .         |  ( )  ||  ( ) || ( ) |
 .         |       ||      ||      |%
 &%&--==--&%-==--%&

You step into the bedroom and are flooded with emotion. Every inch of its surface now looks as if it's been dipped in. The walls are pulsating and warm, shifting from blue to red to violet. .

Lo-fi indie is playing from your computer. You notice movement on the screen. Beside you is a worn out drawer. To the south your kitchen fridge hums. To the north is a cramped closet.

>x computer
A yellowing Windows XP that's seen better days. 

The computer is currently switched off.

* * *

>switch on computer
The monitor lights up with a staticky pop. 
You switch the computer on.

>x computer
Your screen is being populated with a barrage of popups. The same message is written on them. "Your dreams await. \( ^^)/". 

The computer is currently switched on.

>s
Kitchen
Your kitchen has seen better days. A fridge lies in one corner. Near the door is a row of plants with yellowing leaves. At the north corner is a door that leads onto the street.

You can see a plant, a note and a fridge (empty) here.

>n
Bedroom
 .   \_/       .:"    .:"    .:"
 -=(_)=- /\ ||    /\||    /\||
 .   / \     //\\|   //\\|   //\\|
 .          //  \\  //  \\  //  \\
 .         //    \ ^/    \^/    \\
 .         |  ( )  ||  ( ) || ( ) |
 .         |       ||      ||      |%
 &%&--==--&%-==--%&

You step into the bedroom and are flooded with emotion. Every inch of its surface now looks as if it's been dipped in. The walls are pulsating and warm, shifting from blue to red to violet. .

Lo-fi indie is playing from your computer. You notice movement on the screen. Beside you is a worn out drawer. To the south your kitchen fridge hums. To the north is a cramped closet.

>nn
That's not a verb I recognise.

>n
Closet
The closet is small and cramped, with a single cardboard box in the corner. It's dimly lit, and you can smell a faint musty odor, as if the space hasn't been opened in years. The walls are lined with old, forgotten coats, and the ceiling is low, making the space feel claustrophobic.

You can see a suitcase (closed) and a keypad here.

>open suitcase
> This suitcase requires a passcode:

* * *

I beg your pardon?

> This suitcase requires a passcode:

>f
The suitcase beeps. The passcode is incorrect.

>x suitcase
 A small black suitcase and a keypad on the side. It looks like it requires a passcode to open.

>x keypad
A numeric keypad, a little old fashioned. The tag reads "My favourite neopet".

>s
Bedroom
 .   \_/       .:"    .:"    .:"
 -=(_)=- /\ ||    /\||    /\||
 .   / \     //\\|   //\\|   //\\|
 .          //  \\  //  \\  //  \\
 .         //    \ ^/    \^/    \\
 .         |  ( )  ||  ( ) || ( ) |
 .         |       ||      ||      |%
 &%&--==--&%-==--%&

You step into the bedroom and are flooded with emotion. Every inch of its surface now looks as if it's been dipped in. The walls are pulsating and warm, shifting from blue to red to violet. .

Lo-fi indie is playing from your computer. You notice movement on the screen. Beside you is a worn out drawer. To the south your kitchen fridge hums. To the north is a cramped closet.

>i
You are carrying:
  a jug
  a silver key

>unlock drawer with key
The drawer yawns open lazily. In it are a journal, crayons and glasses

>x drawer
It's covered with a layer of dust and lined with faint scratches. You can make out a tiny keyhole in the upper right corner.

In the drawer are a journal, crayons and glasses.

>open drawer
That's already open.

>take all
journal: Taken. A worn out journal in which you've taken to scrawling your dreams.

TABLE OF CONTENTS:
 1.  TOYBOX
 2.  ?????
 3. ?????

You can read the journal by typing: read page N of journal.

crayons: Taken. A bright yellow box. On it are instructions on how to draw certain shapes: a bunny, a lion, a narwhal, and a unicorn. Good for fixing things, if you're in the right place.

glasses: Taken. A wacky looking pair of with black frames and blue-purple swirling lenses. On the side are the words  Sentence Scrambler.

>x glasses
A wacky looking pair of with black frames and blue-purple swirling lenses. On the side are the words  Sentence Scrambler.

>x crayons
A bright yellow box. On it are instructions on how to draw certain shapes: a bunny, a lion, a narwhal, and a unicorn. Good for fixing things, if you're in the right place.

>read page 3 of journal
Page 3 appears to be blank.

>read page 2 of journal
Page 2 appears to be blank.

>read page 2 of journal
Page 2 appears to be blank.

>read journal
You need to specify a page to read.

* * *

>x ladder
The ladder leans against the tree, but some of its rungs are missing.

>x page
You can't see any such thing.

>x hands
You can't see any such thing.

>x self
As good-looking as ever.

>x swings
A rusted thing. Doesn't look safe to swing on.

>x swing
A rusted thing. Doesn't look safe to swing on.

>draw on ladder
What do you want to draw on the ladder with?

>draw on ladder with crayons
You color in the missing gaps with the silver crayon. Good as new.

* * *

>climb ladder
You climb the ladder.

Treehouse
You have entered a cozy treehouse. It has a wooden floor, a small table with some board games, a hammock, and a small girl around the age of 6. There's a window with a view of the forest below.

The girl is doodling furiously. It's some sort of composition of flowers. Every moment she pauses to wipe her wax-covered hands on her skirt. When she sees you, she cries out in delight.

"I see you managed to fix the ladder," she says. I was getting bored up here. What took you so long?"

>x girl
A small girl wearing a checkered dress. Her hair is in neat plaits and her socks are mismatched. She looks familiar.

You can interact with her by typing: ask girl about `topic`. The topic should be a singular word.

>ask girl about name
Huuuh? I'm Emma, silly. Did you hit your head on the way down here?

>ask girl about hi
Emma crushes you in a hug. You found me!

>ask emma about flowers
Emma brightens up. "Yes! I'm trying to draw a specific flower... for a wish. It's yellow, and then not yellow. When it's old it becomes a puffball.

>ask emma about drawing
"C'mon! Let's draw together", she cries.

* * *

>sleep
You aren't feeling especially drowsy.

>sex
That's not a verb I recognise.

* * *

>sleep
You aren't feeling especially drowsy.

>sleep
You aren't feeling especially drowsy.

>sleep in bed
I only understood you as far as wanting to sleep.

* * *

>take all
There are none at all available!

>i
You are carrying:
  a ballpoint pen
  a newsprint
  two papers

>open nightstand
You pull open the drawer. A book, a box of crayons, and a housekey lies inside.

>take all
book: Taken.
crayons: Taken.
housekey: Taken.

>i
You are carrying:
  a housekey
  crayons
  a book (closed and locked)
  a ballpoint pen
  a newsprint
  two papers

>draw bunny on paper
You can't see any such thing.

>draw bunny on two papers
*** Run-time problem P10: Since nothing is not allowed the property "doodle", it is against the rules to try to use it.

* * *

>take all
There are none at all available!

>open drawer
It seems to be locked.

>x drawer
It's covered with a layer of dust and lined with faint scratches. You can make out a tiny keyhole in the upper right corner.

>x journal
You can't see any such thing.

>x crayons
You can't see any such thing.

>x housekey
You can't see any such thing.

>unlock book with housekey
You can't see any such thing.

>unlock journal with housekey
You can't see any such thing.

>i
You are carrying nothing.

* * *

>read journal
You can't see any such thing.

I beg your pardon?

>i
You are carrying nothing.

>x room
You can't see any such thing.

>look around
You can't see any such thing.

>i
You are carrying nothing.

>go to kitchen
Kitchen
Your kitchen has seen better days. A fridge lies in one corner. Near the door is a row of plants with yellowing leaves. At the north corner is a door that leads onto the street.

You can see a jug, a plant, a note and a fridge (closed) here.

* * *

>open fridge
The fridge contains a jug and a piece of candy. The candy beckons to you.

>take all
jug: Taken. You see nothing special about the jug.

candy: You pocket the candy. It feels heavy, like nostalgia.

>eat apple
You can't see any such thing.

>i
You are carrying:
  a candy
  a jug

>open
What do you want to open?

>look around
You can't see any such thing.

>look at Kitchen
You can't see any such thing.

>open
What do you want to open?

>open
What do you want to open?

>x fridge
You're bizarrely attached to your fridge. It's charming in its age, rickedy, humming in a contented manner. It's covered with  and a note is pinned to it.

>x bedroom
You can't see any such thing.

>go to bedroom
Bedroom
 .   \_/       .:"    .:"    .:"
 -=(_)=- /\ ||    /\||    /\||
 .   / \     //\\|   //\\|   //\\|
 .          //  \\  //  \\  //  \\
 .         //    \ ^/    \^/    \\
 .         |  ( )  ||  ( ) || ( ) |
 .         |       ||      ||      |%
 &%&--==--&%-==--%&

Your bedroom is unadorned. The walls are chalky and the ground bare. The only decoration is a poster of The Killers. A lightbulb hangs from the ceiling. A tiny window is opened a crack, and the sound of faint static comes through..

In the corner your monitor blinks wearily. You must've forgotten to turn it off.  Beside you is a worn out drawer. To the south your kitchen fridge hums. To the north is a cramped closet.

* * *

>close popups
You can't see any such thing.

>turn off computer
That's already off.

I beg your pardon?

* * *

>turn computer on
The monitor lights up with a staticky pop. 
You switch the computer on.

* * *

>go to kitchen
Kitchen
Your kitchen has seen better days. A fridge lies in one corner. Near the door is a row of plants with yellowing leaves. At the north corner is a door that leads onto the street.

You can see a plant, a note and a fridge (empty) here.

>open fridge
That's already open.

>eat candy
You unwrap the candy and pop it in your mouth. It tastes of a strange medley of flavours - vanilla custard, citrus, a hint of buttered toast. Delightful.

A sudden prickling rips through your throat, like you've swallowed something you shouldn't have. You double over, coughing, clutching the counter for balance. There's something lodged in your throat.

Clang! Out comes a small piece of metal. You pick it up, bewildered. It's a small key.

>go to bedroom
Bedroom
 .   \_/       .:"    .:"    .:"
 -=(_)=- /\ ||    /\||    /\||
 .   / \     //\\|   //\\|   //\\|
 .          //  \\  //  \\  //  \\
 .         //    \ ^/    \^/    \\
 .         |  ( )  ||  ( ) || ( ) |
 .         |       ||      ||      |%
 &%&--==--&%-==--%&

You step into the bedroom and are flooded with emotion. Every inch of its surface now looks as if it's been dipped in. The walls are pulsating and warm, shifting from blue to red to violet. .

Lo-fi indie is playing from your computer. You notice movement on the screen. Beside you is a worn out drawer. To the south your kitchen fridge hums. To the north is a cramped closet.

* * *

>take all
journal: Taken. A worn out journal in which you've taken to scrawling your dreams.

TABLE OF CONTENTS:
 1  TOYBOX
 2  ?????
 3  ?????

crayons: Taken. A bright yellow box. On it are instructions on how to draw certain shapes: a bunny, a lion, a narwhal, and a unicorn.

glasses: Taken. A wacky looking pair of with black frames and blue-purple swirling lenses. On the side are the words  Sentence Scrambler.

>open drawer
That's already open.

>take all
There are none at all available!

>i
You are carrying:
  glasses
  crayons
  a journal (closed)
  a silver key
  a jug

>x journal
A worn out journal in which you've taken to scrawling your dreams.

TABLE OF CONTENTS:
 1  TOYBOX
 2  ?????
 3  ?????

>read page 2 of journal
Page 2 appears to be blank.

>read page 1 of journal
A thunderous crack cuts through the air. Everything begins to spin. You watch as everything around you dissolves and reforms until your eyes begin to burn from the distortion. 1. "TOYBOX"

Toybox (Dreamland)
 |                  /\   
 |                 / | \ 
 |                / | | \ 
 |               /_|_|_|_
 |                |     / /
 |__    __    __ |    / /__    __    __
 |  |__|  |__|  |.   / /|  |__|  |__|  |
 |__            ____/ /___           __|
 |          / .------  )         |
 |         / /        /          |  TOYBOX
 |        / /        /           |
 ~~~~~~~~~~~~-----------~~~~~~~~

You open your eyes to pure whiteness. Every bit of empty space is blue lines, pink margins...

Margins! That's it. The world you're in is rendered on notebook paper. Objects are flat, paperlike, outlined in waxy lines. You look down at your hands and suppress a cry of shock. You're wearing a triangular smock of purple and your body is composed of black lines. You unfurl your fingers and watch as the lines retract and relax.

You take in the rest of your surroundings. You seem to be in a playground of sorts. There's a set of swings and a playstructure in a garish primary colours. In the distance is a forest, the paper trees swaying in the wind. One of the trees stands proudly in the center, a broken ladder propped against it.

A girl no older than five is playing in the field. She's crawling through the grass, plucking out a stem here and there.

>x ladder
The ladder leans against the tree, but some of its rungs are missing.

>draw on ladder
What do you want to draw on the ladder with?

* * *

>climb ladder
You climb the ladder.

Treehouse
You have entered a cozy treehouse. It has a wooden floor, a small table with some board games, a hammock, and a girl named Emma who is sitting on a bean bag chair. There's a window with a view of the forest below.

You can see Emma here.

>talk to emma
That's not a verb I recognise.

>say hi to emma
She crushes you in a hug. You found me!

>draw dandelion
I didn't understand that sentence.

* * *

>draw dandelion with crayons
You use the crayons to carefully draw a bright yellow dandelion. The petals are vivid, and the stem is a bright green. The drawing looks almost alive.

The air sizzles, and with a pop, something drops in your pocket

>i
You are carrying:
  a dandelion
  glasses
  crayons
  a journal (closed)
  a silver key
  a jug

>give dandelion to emma
Emma looks up at you in wonder. "A dandelion", she whispers reverentially. "I've never seen one before."

You tell her they're commonplace where you're from. "That can't be right," she says. "My grandma says they went extinct long ago. They were killed, you know. For being too resilient. She cups the fluffy white thing delicately. "C'mon! Let's wish together."

You put your heads together and your breaths create a flurry of white as the spores release into the air. You stare at this strange girl, wide-eyed with awe, twirling the empty stem in her hands. You're drawn to her uncomplicated joy.

"I wished for a friend," she says abruptly. She gazes at you in wonder. "I've never had a friend. Will you be my friend?

> Befriend Emma? Y/N

* * *

>n
Closet
The closet is small and cramped, with a single cardboard box in the corner. It's dimly lit, and you can smell a faint musty odor, as if the space hasn't been opened in years. The walls are lined with old, forgotten coats, and the ceiling is low, making the space feel claustrophobic.

You can see a suitcase (closed) here.

>open suitcase
> This suitcase requires a passcode:

* * *

>jubjub
The suitcase clicks open. Inside the suitcase is a collection of random objects, a yearbook, a record player, and a narwhal

>take all
yearbook: Taken. .

narwhal: Taken. An old hurt vibrates through you. You can't place why.

>x journal
A worn out journal in which you've taken to scrawling your dreams.

TABLE OF CONTENTS:
 1  TOYBOX
 2  PLUSHIELAND
 3  TERMINAL

>read page 2 of jorunal
You can't see any such thing.

>read page 2 of journal
A thunderous crack cuts through the air. Everything begins to spin. You watch as everything around you dissolves and reforms until your eyes begin to burn from the distortion. 2. "PLUSHIELAND"

Plushieland
You wake up in world of cotton. Everything you see is rendered in a shade of pastel - the turgid river, the sky, the meadows in front of you. A girl around the age of seven is digging up flowers. Surrounding you are 

You can see Emma here.

>save
Save failed.

>ask emma about toy
Emma doesn't seem to hear you. She seems lost in a daydream.

>give narwhal to emma
She scoffs at the plushies. "I'm not talking about a narwhal, silly! Mr. Narkins is way smarter at that thing. We used to play Faerie Bubbles together.

* * *

>take all
There are none at all available!

>open nightstand
You pull open the drawer. A book, a box of crayons, and a housekey lies inside.

* * *

>take all
book: Taken.
crayons: Taken.
housekey: Taken.

>draw bunny on book
You can't see any such thing.

>take all
There are none at all available!

>i
You are carrying:
  a housekey
  crayons
  a book (closed and locked)
  a ballpoint pen
  a newsprint

>draw unicorn on book
You can't see any such thing.

>draw unicorn on book
You can't see any such thing.

>draw on book
You doodle on the book. Looks cute.

>draw bunny on book
You can't see any such thing.

>draw book on book
I only understood you as far as wanting to draw the book.

>draw computer on book
I only understood you as far as wanting to draw the computer.

>draw on book
You doodle on the book. Looks cute.

>draw on book
You doodle on the book. Looks cute.

>draw on book book
You doodle on the book. Looks cute.

>draw book on book
I only understood you as far as wanting to draw the book.

>draw on book
You doodle on the book. Looks cute.

* * *

>tt
That's not a verb I recognise.

>x emma
The girl is wearing a red checkered dress. Her hair is in knotted and face streaked with mud. Her ankle is red and swelling.

The shadows are growing darker.

I beg your pardon?

>leave emma
You feel like you're being sucked out of this world. You feel a whirlwind of crying, of pain, of grief, of everything crashing down on you in that moment. When the whirling stops you find yourself in your bedroom. Wake up.

Bedroom
 .   \_/       .:"    .:"    .:"
 -=(_)=- /\ ||    /\||    /\||
 .   / \     //\\|   //\\|   //\\|
 .          //  \\  //  \\  //  \\
 .         //    \ ^/    \^/    \\
 .         |  ( )  ||  ( ) || ( ) |
 .         |       ||      ||      |%
 &%&--==--&%-==--%&

Your bedroom is unadorned. The walls are chalky and the ground bare. The only decoration is a poster of The Killers. A lightbulb hangs from the ceiling. A tiny window is opened a crack, and the sound of faint static comes through. In the distance your kitchen fridge hums.

In the corner your monitor blinks wearily. You must've forgotten to turn it off.  Beside you is a worn out drawer. To the left is a cramped closet.

>go to kitchen
Kitchen
Your kitchen has seen better days. A fridge lies in one corner. Near the door is a row of plants with yellowing leaves. At the north corner is a door that leads onto the street.

You can see a note and a fridge (closed) here.

>open fridge
The fridge contains ?????? ??? ?? ????? ??????? ??????? ?? ????
 and curiously, a piece of candy. The candy beckons to you.

* * *

>unlock drawer
(with the silver key)
You unlock the drawer.

* * *

>open drawer
You pull open the drawer. A journal, a box of crayons, and a pair of glasses  lies inside. The journal beckons to you.

>take all
newsprint: Taken. You straighten out the sheet of newspaper, handling it delicately.  The page contains two girls playing in a sandbox. The smaller of the two is labouring over a crudely formed sand sculpture. The other is carelessly sprawled across the sand, her body covered in dust. You study the small stature, the neat braids, the wrinkled clothing. They look around preschool age. 

¯¯̿̿¯̿̿"̿̿̿̿̿̿̿"̿̿"̿̿̿̿̿"̿̿̿)͇̿̿)̿̿̿̿ "̿̿̿̿̿̿\̵͇̿̿\=(•̪̀●́)=o/̵͇̿̿/. You can't make out the caption.

journal: Taken. A worn out journal in which you've taken to scrawling your dreams.

crayons: Taken. A bright yellow box. On it are instructions on how to draw certain shapes: a bunny, a lion, a narwhal, and a unicorn.

glasses: Taken. You see nothing special about glasses.

>read journal
You flip the pages randomly and arrive at page 3:

A thunderous crack cuts through the air. Everything begins to spin. You watch as everything around you dissolves and reforms until your eyes begin to burn from the distortion. 3. "??????"

Toybox (Dreamland)
 |                  /^\   / -- )
 |                 / | \ (____/
 |                / | | \ / /
 |               /_|_|_|_/ /
 |                |     / /
 | __    __    __ |    / /__    __    __
 |  |__|  |__|  |.   / /|  |__|  |__|  |
 |__            ____/ /___           __|
 |          / .------  )         |
 |         / /        /          |  TOYBOX
 |        / /        /           |
 ~~~~~~~~~~~~-----------~~~~~~~~

You open your eyes to pure whiteness. Every bit of empty space is blue lines, pink margins...

Margins! That's it. The world you're in is rendered on notebook paper. Objects are flat, paperlike, outlined in waxy lines. You look down at your hands and suppress a cry of shock. You're wearing a triangular smock of purple and your body is composed of black lines. You unfurl your fingers and watch as the lines retract and relax.

You take in the rest of your surroundings. You seem to be in a playground of sorts. There's a set of swings and a playstructure in a garish primary colours. In the distance is a forest, the paper trees swaying in the wind.

A girl no older than five is playing in the field. She's crawling through the grass, plucking out a stem here and there.

>say hi to girl
Emma doesn't seem to hear you. She seems lost in a daydream.

>look at girl
The girl is wearing a red checkered dress. Her hair is in knotted and face streaked with mud. Her ankle is red and swelling.

>say hi to emma
Emma is humming to herself.

>talk to emma
That's not a verb I recognise.

>ask emma about hi
Emma is humming to herself.

>ask emma about grerg
Emma doesn't seem to hear you. She seems lost in a daydream.

>ask emma about emma
Emma is too busy digging through the meadow.

>draw clover with crayons
I only understood you as far as wanting to draw the clover.

>draw dandelion with crayons
I only understood you as far as wanting to draw the dandelion.

>draw dandelion
(with the crayons) You doodle a dandelion. Looks cute. Something drops in your pocket.

>i
You are carrying:
  a dandelion
  glasses
  crayons
  a journal (closed)
  a newsprint
  a silver key

>give dandelion to emma
Emma looks up at you in wonder. "A dandelion", she whispers reverentially. "I've never seen one before."

You tell her they're commonplace where you're from. "That can't be right," she says. "My grandma says they went extinct long ago. They were killed, you know. For being too resilient. She cups the fluffy white thing delicately. "C'mon! Let's wish together."

You put your heads together and your breaths create a flurry of white as the spores release into the air. You stare at this strange girl, wide-eyed with awe, twirling the empty stem in her hands. You're drawn to her uncomplicated joy."

>go to bedroom
Bedroom
 .   \_/       .:"    .:"    .:"
 -=(_)=- /\ ||    /\||    /\||
 .   / \     //\\|   //\\|   //\\|
 .          //  \\  //  \\  //  \\
 .         //    \ ^/    \^/    \\
 .         |  ( )  ||  ( ) || ( ) |
 .         |       ||      ||      |%
 &%&--==--&%-==--%&

You step into the bedroom and are flooded with emotion. Every inch of its surface now looks as if it's been dipped in iridescence. The walls are pulsating and warm, shifting from blue to red to violet. The scent of lilacs fill the air.  In the distance your kitchen fridge hums.

Lo-fi indie is playing from your computer. You notice movement on the screen. Beside you is a worn out drawer. To the left is a cramped closet.

>go to closet
Closet
It's empty except for a single cardbord box. You feel cramped.

You can see a cardboard box (closed) here.

>open
What do you want to open?

>open box
Inside is a yearbook, a record player, a binder, and a 3D printed narwhal, amongst other odds and ends.
The closet smells dusty.

>x binder
You can't see any such thing.

>x record
A vintage turntable. It's loaded with a vinyl - Best of 2010s Hits.

Record player is currently switched off.

>turn on
What do you want to turn on?

>turn on record
You switch record player on.

Phoebe Bridgers fills the room.

>x binder
You can't see any such thing.

>open drawer
You can't see any such thing.

>put on glasses
You put on glasses.

Twice fills the room.

>i
You are carrying:
  a dandelion
  glasses (being worn)
  crayons
  a journal (closed)
  a newsprint
  a silver key

Twenty One Pilots fills the room.

* * *

>turn light on
You pull on the lightbulb. Things seem a little brighter.

You switch the lightbulb on.

>x computer
A yellowing Windows XP that's seen better days. 

The computer is currently switched off.

>turn computer on
The monitor lights up.

You switch the computer on.

>go to kitchen
Kitchen
Your kitchen has seen better days. A fridge lies in one corner. Near the door is a row of plants with yellowing leaves. At the north corner is a door that leads onto the street.

You can see a jug, a plant, a note and a fridge (closed) here.

>x fridge
You're bizarrely attached to your fridge. It's charming in its age, rickedy, humming in a contented manner. It's covered with  and a note is pinned to it.

>x note
There's a note stuck to the fridge. It reads  ??? ??? ????????? ???? You can't make out the text ."

>open fridge
The fridge contains ??? ??? ????????? ???? You can't make out the text.
 and curiously, a piece of candy. The candy beckons to you.

>eat candy
(first taking the candy)
You pocket the candy. It feels heavy, like nostalgia.

You unwrap the candy and pop it in your mouth. It tastes of a strange medley of flavours - vanilla custard, citrus, a hint of buttered toast. Delightful.

A sudden prickling rips through your throat, like you've swallowed something you shouldn't have. You double over, coughing, clutching the counter for balance. There's something lodged in your throat.

Clang! Out comes a small piece of metal. You pick it up, bewildered. It's a small key.

>x note
There's a note stuck to the fridge. It reads  "Where did you go? Come play with me in Dreamland /( ^^)/."

>x fridge
You're bizarrely attached to your fridge. It's charming in its age, rickedy, humming in a contented manner. It's covered with  and a note is pinned to it.

In the fridge are a black vial, a 'Drink Me' potion, shortcake and crackers.

>take all
jug: Taken. You see nothing special about the jug.

* * *

>i
You are carrying:
  a jug
  a silver key

>go to room
That noun did not make sense in this context.

>go to bedroom
Bedroom
 .   \_/       .:"    .:"    .:"
 -=(_)=- /\ ||    /\||    /\||
 .   / \     //\\|   //\\|   //\\|
 .          //  \\  //  \\  //  \\
 .         //    \ ^/    \^/    \\
 .         |  ( )  ||  ( ) || ( ) |
 .         |       ||      ||      |%
 &%&--==--&%-==--%&

You step into the bedroom and are flooded with emotion. Every inch of its surface now looks as if it's been dipped in. The walls are pulsating and warm, shifting from blue to red to violet.  In the distance your kitchen fridge hums.

Lo-fi indie is playing from your computer. You notice movement on the screen. Beside you is a worn out drawer. To the left is a cramped closet.

>x drawer
It's covered with a layer of dust and lined with faint scratches. You can make out a tiny keyhole in the upper right corner.

>unlock drawer
What do you want to unlock the drawer with?

>x note
You can't see any such thing.

>unlock drawer with key
You unlock the drawer.

* * *

>take all
journal: Taken. A worn out journal in which you've taken to scrawling your dreams.

crayons: Taken. A bright yellow box. On it are instructions on how to draw certain shapes: a bunny, a lion, a narwhal, and a unicorn.

glasses: Taken. A wacky looking pair of with black frames and blue-purple swirling lenses. On the side are the words  Sentence Scrambler.

>put on glasses
You put on glasses.

>go to closet
Closet
It's empty except for a single cardbord box. You feel cramped.

You can see a cardboard box (closed) here.

>open closer
You can't see any such thing.

>open box
Inside is a yearbook, a record player, a binder, and a 3D printed narwhal, amongst other odds and ends.
The closet smells dusty.

>turn on record player
You switch record player on.

Phoebe Bridgers fills the room.

>take all
cardboard box: Taken. In the cardboard box are a yearbook, record player and narwhal.

yearbook: Taken. Class of XXYZ.

narwhal: Taken. An old hurt vibrates through you. You can't place why.

Twice fills the room.

>go to bedroom
Bedroom
 .   \_/       .:"    .:"    .:"
 -=(_)=- /\ ||    /\||    /\||
 .   / \     //\\|   //\\|   //\\|
 .          //  \\  //  \\  //  \\
 .         //    \ ^/    \^/    \\
 .         |  ( )  ||  ( ) || ( ) |
 .         |       ||      ||      |%
 &%&--==--&%-==--%&

You step into the bedroom and are flooded with emotion. Every inch of its surface now looks as if it's been dipped in. The walls are pulsating and warm, shifting from blue to red to violet.  In the distance your kitchen fridge hums.

Lo-fi indie is playing from your computer. You notice movement on the screen. Beside you is a worn out drawer. To the left is a cramped closet. 

Twenty One Pilots fills the room.

>read journal
You flip the pages randomly and arrive at page 3:

A thunderous crack cuts through the air. Everything begins to spin. You watch as everything around you dissolves and reforms until your eyes begin to burn from the distortion. 3. "??????"

Toybox (Dreamland)
 |                  /^\   / -- )
 |                 / | \ (____/
 |                / | | \ / /
 |               /_|_|_|_/ /
 |                |     / /
 | __    __    __ |    / /__    __    __
 |  |__|  |__|  |.   / /|  |__|  |__|  |
 |__            ____/ /___           __|
 |          / .------  )         |
 |         / /        /          |  TOYBOX
 |        / /        /           |
 ~~~~~~~~~~~~-----------~~~~~~~~

You open your eyes to pure whiteness. Every bit of empty space is blue lines, pink margins...

Margins! That's it. The world you're in is rendered on notebook paper. Objects are flat, paperlike, outlined in waxy lines. You look down at your hands and suppress a cry of shock. You're wearing a triangular smock of purple and your body is composed of black lines. You unfurl your fingers and watch as the lines retract and relax.

You take in the rest of your surroundings. You seem to be in a playground of sorts. There's a set of swings and a playstructure in a garish primary colours. In the distance is a forest, the paper trees swaying in the wind.

A girl no older than five is playing in the field. She's crawling through the grass, plucking out a stem here and there.

Twenty One Pilots fills the room.

>talk to girl
That's not a verb I recognise.

>say hi to girl
She crushes you in a hug. You found me!

Pussy Riot fills the room.

>ask emma about wish
You feel it too, don't you? whispers the girl. This is a magic place.

Fall Out Boy fills the room.

>ask emma about flower
Emma doesn't seem to hear you. She seems lost in a daydream.

Twice fills the room.

>ask emma about dandelion
The girl looks up at you in wonder. So you do know the story! Could'ya help me look? Pretty please!

Bruno Mars fills the room. You're on the verge of tears, but you're not sure why.

>doodle dandelion with crayons
That's not a verb I recognise.

>draw dandelion with crayons
(with the crayons) You doodle a dandelion with crayons. Looks cute.

Twenty One Pilots fills the room.

>draw clover with crayon
(with the crayons) You doodle a clover with crayon. Looks cute.

Twenty One Pilots fills the room.

>draw bunny with crayon
(with the crayons) You doodle a bunny with crayon. Looks cute.

Twenty One Pilots fills the room.

>draw dandelion with crayons
(with the crayons) You doodle a dandelion with crayons. Looks cute.

Pussy Riot fills the room.

>i
You are carrying:
  narwhal
  a yearbook (open but empty)
  a cardboard box (open)
    record player
  glasses (being worn)
  crayons
  a journal (closed)
  a jug
  a silver key

Twenty One Pilots fills the room.

>take all
There are none at all available!

>draw dandelion with crayons
(with the crayons) You doodle a dandelion with crayons. Looks cute.

Fall Out Boy fills the room.

>draw dandelion
(with the crayons) You doodle a dandelion. Looks cute. The air sizzles, and with a pop, the dandelion is splits from its surroundings. Something drops in your pocket.

Twenty One Pilots fills the room.

>i
You are carrying:
  a dandelion
  narwhal
  a yearbook (open but empty)
  a cardboard box (open)
    record player
  glasses (being worn)
  crayons
  a journal (closed)
  a jug
  a silver key

Bruno Mars fills the room. You're on the verge of tears, but you're not sure why.

>give dandelion to emma
Emma looks up at you in wonder. "A dandelion", she whispers reverentially. "I've never seen one before."

You tell her they're commonplace where you're from. "That can't be right," she says. "My grandma says they went extinct long ago. They were killed, you know. For being too resilient. She cups the fluffy white thing delicately. "C'mon! Let's wish together."

You put your heads together and your breaths create a flurry of white as the spores release into the air. You stare at this strange girl, wide-eyed with awe, twirling the empty stem in her hands. You're drawn to her uncomplicated joy.

"I wished for a friend," she says abruptly. She gazes at you in wonder. "I've never had a friend. Will you be my friend?

Bruno Mars fills the room. You're on the verge of tears, but you're not sure why.

> Befriend Emma? Y/N

>y
Her face blooms with delight. "YAAAAY", she cries. "We can all be friends now. Me, you, Mr. Narkins.

Her face darkens for a second. "Have you seen him, by the way? He's a sea unicorn." You feel suction around you, like you're going through a vacuum. Everything blurs.

Bedroom
 .   \_/       .:"    .:"    .:"
 -=(_)=- /\ ||    /\||    /\||
 .   / \     //\\|   //\\|   //\\|
 .          //  \\  //  \\  //  \\
 .         //    \ ^/    \^/    \\
 .         |  ( )  ||  ( ) || ( ) |
 .         |       ||      ||      |%
 &%&--==--&%-==--%&

You step into the bedroom and are flooded with emotion. Every inch of its surface now looks as if it's been dipped in. The walls are pulsating and warm, shifting from blue to red to violet.  In the distance your kitchen fridge hums.

Lo-fi indie is playing from your computer. You notice movement on the screen. Beside you is a worn out drawer. To the left is a cramped closet. 

That was a rhetorical question.

Twenty One Pilots fills the room.

>x computer
Your screen is being populated with a barrage of popups. The same message is written on them. "Your dreams await. \( ^^)/". 

The computer is currently switched on.

Pussy Riot fills the room.

* * *

>turn on lightbulb
You pull on the lightbulb. Things seem a little brighter.

You switch the lightbulb on.

>clear
What do you want to clear?

* * *

>use the monitor
That's not a verb I recognise.

>open drawer
It seems to be locked.

>open closet
You can't see any such thing.

>go to closet
Closet
It's empty except for a single cardbord box. You feel cramped.

You can see a cardboard box (closed) here.

* * *

>open box
Inside is a yearbook, a record player, a binder, and a 3D printed narwhal, amongst other odds and ends.
The closet smells dusty.

>x yearbook
 ¯¯̿̿¯̿̿"̿̿̿̿̿̿̿"̿̿"̿̿̿̿̿"̿̿̿)͇̿̿)̿̿̿̿ "̿̿̿̿̿̿\̵͇̿̿\=(•̪̀●́)=o/̵͇̿̿/"̿̿ ̿ ̿̿ .

>x record player
A vintage turntable. It's loaded with a vinyl - Best of 2010s Hits.

Record player is currently switched off.

* * *

>turn on record player
You switch record player on.

Phoebe Bridgers fills the room.

>go to fridge
That noun did not make sense in this context.

>go to kitchen
Kitchen
Your kitchen has seen better days. A fridge lies in one corner. Near the door is a row of plants with yellowing leaves. At the north corner is a door that leads onto the street.

You can see a note and a fridge (closed) here.

>read note
You flip the pages randomly and arrive at page 3:

The drawer isn't open.

>open fridge
The fridge contains ?????? ??? ?? ????? ??????? ??????? ?? ????
 and curiously, a piece of candy. The candy beckons to you.

* * *

>i
You are carrying:
  a silver key

>open drawer
You can't see any such thing.

>go to room
That noun did not make sense in this context.

>go to bedroom
Bedroom
 .   \_/       .:"    .:"    .:"
 -=(_)=- /\ ||    /\||    /\||
 .   / \     //\\|   //\\|   //\\|
 .          //  \\  //  \\  //  \\
 .         //    \ ^/    \^/    \\
 .         |  ( )  ||  ( ) || ( ) |
 .         |       ||      ||      |%
 &%&--==--&%-==--%&

You step into the bedroom and are flooded with emotion. Every inch of its surface now looks as if it's been dipped in. The walls are pulsating and warm, shifting from blue to red to violet. The scent of lilacs fill the air.  In the distance your kitchen fridge hums.

Lo-fi indie is playing from your computer. You notice movement on the screen. Beside you is a worn out drawer. To the left is a cramped closet.

>go to drawer
That noun did not make sense in this context.

>open drawer
It seems to be locked.

>use key on drawer
That's not a verb I recognise.

>unlock drawer
(with the silver key)
You unlock the drawer.

* * *

>take journal
Taken. A worn out journal in which you've taken to scrawling your dreams.

>x journal
A worn out journal in which you've taken to scrawling your dreams.

>read journal
You flip the pages randomly and arrive at page 4:

A thunderous crack cuts through the air. Everything begins to spin. You watch as everything around you dissolves and reforms until your eyes begin to burn from the distortion. 4. "???????"

Toybox (Dreamland)
 |                  /^\   / -- )
 |                 / | \ (____/
 |                / | | \ / /
 |               /_|_|_|_/ /
 |                |     / /
 | __    __    __ |    / /__    __    __
 |  |__|  |__|  |.   / /|  |__|  |__|  |
 |__            ____/ /___           __|
 |          / .------  )         |
 |         / /        /          |  TOYBOX
 |        / /        /           |
 ~~~~~~~~~~~~-----------~~~~~~~~

You open your eyes to pure whiteness. Every bit of empty space is blue lines, pink margins...

Margins! That's it. The world you're in is rendered on notebook paper. Objects are flat, paperlike, outlined in waxy lines. You look down at your hands and suppress a cry of shock. You're wearing a triangular smock of purple and your body is composed of black lines. You unfurl your fingers and watch as the lines retract and relax.

You take in the rest of your surroundings. You seem to be in a playground of sorts. There's a set of swings and a playstructure in a garish primary colours. In the distance is a forest, the paper trees swaying in the wind.

A girl no older than five is playing in the field. She's crawling through the grass, plucking out a stem here and there.

>take crayons
You can't see any such thing.

>go to drawer
That noun did not make sense in this context.

>go to bedroom
Bedroom
 .   \_/       .:"    .:"    .:"
 -=(_)=- /\ ||    /\||    /\||
 .   / \     //\\|   //\\|   //\\|
 .          //  \\  //  \\  //  \\
 .         //    \ ^/    \^/    \\
 .         |  ( )  ||  ( ) || ( ) |
 .         |       ||      ||      |%
 &%&--==--&%-==--%&

You step into the bedroom and are flooded with emotion. Every inch of its surface now looks as if it's been dipped in. The walls are pulsating and warm, shifting from blue to red to violet. The scent of lilacs fill the air.  In the distance your kitchen fridge hums.

Lo-fi indie is playing from your computer. You notice movement on the screen. Beside you is a worn out drawer. To the left is a cramped closet.

>open drawer
That's already open.

>take all
crayons: Taken. A bright yellow box. On it are instructions on how to draw certain shapes: a bunny, a lion, a narwhal, and a unicorn.

glasses: Taken. A wacky looking pair of with black frames and blue-purple swirling lenses. On the side are the words  Sentence Scrambler.

>i
You are carrying:
  glasses
  crayons
  a journal (closed)
  a silver key

>use glasses
That's not a verb I recognise.

>wear glasses
You put on glasses.

>read journal
You flip the pages randomly and arrive at page 3:

A thunderous crack cuts through the air. Everything begins to spin. You watch as everything around you dissolves and reforms until your eyes begin to burn from the distortion. 3. "??????"

Toybox (Dreamland)
 |                  /^\   / -- )
 |                 / | \ (____/
 |                / | | \ / /
 |               /_|_|_|_/ /
 |                |     / /
 | __    __    __ |    / /__    __    __
 |  |__|  |__|  |.   / /|  |__|  |__|  |
 |__            ____/ /___           __|
 |          / .------  )         |
 |         / /        /          |  TOYBOX
 |        / /        /           |
 ~~~~~~~~~~~~-----------~~~~~~~~

You open your eyes to pure whiteness. Every bit of empty space is blue lines, pink margins...

Margins! That's it. The world you're in is rendered on notebook paper. Objects are flat, paperlike, outlined in waxy lines. You look down at your hands and suppress a cry of shock. You're wearing a triangular smock of purple and your body is composed of black lines. You unfurl your fingers and watch as the lines retract and relax.

You take in the rest of your surroundings. You seem to be in a playground of sorts. There's a set of swings and a playstructure in a garish primary colours. In the distance is a forest, the paper trees swaying in the wind.

A girl no older than five is playing in the field. She's crawling through the grass, plucking out a stem here and there.

>talk to girl
That's not a verb I recognise.

>ask girl
What do you want to ask Emma for?

>ask girl about margins
Emma doesn't seem to hear you. She seems lost in a daydream.

>ask girl about grass
The girl looks solemn, "I'm looking for something. It's a special plant. My grandma told me it's got special powers, and I need it to make a wish.

>ask girl about special plant
Emma doesn't seem to hear you. She seems lost in a daydream.

>ask girl about plant
Emma is too busy digging through the meadow.

>ask girl about wish
You feel it too, don't you? whispers the girl. This is a magic place.

>ask girl about magic
You feel it too, don't you? whispers the girl. This is a magic place.

>draw plant
(with the crayons) You doodle a plant. Looks cute.

>draw plant on girl
(with the crayons) You doodle a plant on girl. Looks cute.

>draw dandelion
(with the crayons) You doodle a dandelion. Looks cute. The air sizzles, and with a pop, the dandelion is splits from its surroundings. Something drops in your pocket.

>i
You are carrying:
  a dandelion
  glasses (being worn)
  crayons
  a journal (closed)
  a silver key

>give girl dandelion
Emma looks up at you in wonder. "A dandelion", she whispers reverentially. "I've never seen one before."

You tell her they're commonplace where you're from. "That can't be right," she says. "My grandma says they went extinct long ago. They were killed, you know. For being too resilient. She cups the fluffy white thing delicately. "C'mon! Let's wish together."

You put your heads together and your breaths create a flurry of white as the spores release into the air. You stare at this strange girl, wide-eyed with awe, twirling the empty stem in her hands. You're drawn to her uncomplicated joy.

"I wished for a friend," she says abruptly. She gazes at you in wonder. "I've never had a friend. Will you be my friend?

> Befriend Emma? Y/N

>Y
Her face blooms with delight. "YAAAAY", she cries. "We can all be friends now. Me, you, Mr. Narkins.

Her face darkens for a second. "Have you seen him, by the way? He's a sea unicorn." You feel suction around you, like you're going through a vacuum. Everything blurs.

Bedroom
 .   \_/       .:"    .:"    .:"
 -=(_)=- /\ ||    /\||    /\||
 .   / \     //\\|   //\\|   //\\|
 .          //  \\  //  \\  //  \\
 .         //    \ ^/    \^/    \\
 .         |  ( )  ||  ( ) || ( ) |
 .         |       ||      ||      |%
 &%&--==--&%-==--%&

You step into the bedroom and are flooded with emotion. Every inch of its surface now looks as if it's been dipped in. The walls are pulsating and warm, shifting from blue to red to violet. The scent of lilacs fill the air.  In the distance your kitchen fridge hums.

Lo-fi indie is playing from your computer. You notice movement on the screen. Beside you is a worn out drawer. To the left is a cramped closet. 

That was a rhetorical question.

>i
You are carrying:
  a crayola key
  a dandelion
  glasses (being worn)
  crayons
  a journal (closed)
  a silver key

>go to fridge
That noun did not make sense in this context.

>go to kitchen
Kitchen
Your kitchen has seen better days. A fridge lies in one corner. Near the door is a row of plants with yellowing leaves. At the north corner is a door that leads onto the street.

You can see a note and a fridge (in which are a black vial, a 'Drink Me' potion, shortcake and crackers) here.

>open fridge
That's already open.

>go to bedroom
Bedroom
 .   \_/       .:"    .:"    .:"
 -=(_)=- /\ ||    /\||    /\||
 .   / \     //\\|   //\\|   //\\|
 .          //  \\  //  \\  //  \\
 .         //    \ ^/    \^/    \\
 .         |  ( )  ||  ( ) || ( ) |
 .         |       ||      ||      |%
 &%&--==--&%-==--%&

You step into the bedroom and are flooded with emotion. Every inch of its surface now looks as if it's been dipped in. The walls are pulsating and warm, shifting from blue to red to violet. The scent of lilacs fill the air.  In the distance your kitchen fridge hums.

Lo-fi indie is playing from your computer. You notice movement on the screen. Beside you is a worn out drawer. To the left is a cramped closet.

>x computer
A yellowing Windows XP that's seen better days. 

The computer is currently switched off.

>turn on
What do you want to turn on?

>turn on computer
The monitor lights up.

You switch the computer on.

>x computer
Your screen is being populated with a barrage of popups. The same message is written on them. "Your dreams await. \( ^^)/". 

The computer is currently switched on.

>go to closet
Closet
It's empty except for a single cardbord box. You feel cramped.

You can see a cardboard box (in which are a yearbook (empty), record player and narwhal) here.

Twice fills the room.

>x
What do you want to examine?

>take narwhal
Taken. An old hurt vibrates through you. You can't place why.

>i
You are carrying:
  narwhal
  a crayola key
  a dandelion
  glasses (being worn)
  crayons
  a journal (closed)
  a silver key

>go to bedroom
Bedroom
 .   \_/       .:"    .:"    .:"
 -=(_)=- /\ ||    /\||    /\||
 .   / \     //\\|   //\\|   //\\|
 .          //  \\  //  \\  //  \\
 .         //    \ ^/    \^/    \\
 .         |  ( )  ||  ( ) || ( ) |
 .         |       ||      ||      |%
 &%&--==--&%-==--%&

You step into the bedroom and are flooded with emotion. Every inch of its surface now looks as if it's been dipped in. The walls are pulsating and warm, shifting from blue to red to violet. The scent of lilacs fill the air.  In the distance your kitchen fridge hums.

Lo-fi indie is playing from your computer. You notice movement on the screen. Beside you is a worn out drawer. To the left is a cramped closet.

>read journal
You flip the pages randomly and arrive at page 2:

A thunderous crack cuts through the air. Everything begins to spin. You watch as everything around you dissolves and reforms until your eyes begin to burn from the distortion. 2. "???????"

Toybox (Dreamland)
 |                  /^\   / -- )
 |                 / | \ (____/
 |                / | | \ / /
 |               /_|_|_|_/ /
 |                |     / /
 | __    __    __ |    / /__    __    __
 |  |__|  |__|  |.   / /|  |__|  |__|  |
 |__            ____/ /___           __|
 |          / .------  )         |
 |         / /        /          |  TOYBOX
 |        / /        /           |
 ~~~~~~~~~~~~-----------~~~~~~~~

You open your eyes to pure whiteness. Every bit of empty space is blue lines, pink margins...

Margins! That's it. The world you're in is rendered on notebook paper. Objects are flat, paperlike, outlined in waxy lines. You look down at your hands and suppress a cry of shock. You're wearing a triangular smock of purple and your body is composed of black lines. You unfurl your fingers and watch as the lines retract and relax.

You take in the rest of your surroundings. You seem to be in a playground of sorts. There's a set of swings and a playstructure in a garish primary colours. In the distance is a forest, the paper trees swaying in the wind.

A girl no older than five is playing in the field. She's crawling through the grass, plucking out a stem here and there.

>say hi to emma
She crushes you in a hug. You found me!

>give narwhal to emma
She scoffs at the plushies. "I'm not talking about a narwhal, silly! Mr. Narkins is way smarter at that thing. We used to play Faerie Bubbles together.

>x computer
You can't see any such thing.

>go to kitchen
Kitchen
Your kitchen has seen better days. A fridge lies in one corner. Near the door is a row of plants with yellowing leaves. At the north corner is a door that leads onto the street.

You can see a note and a fridge (in which are a black vial, a 'Drink Me' potion, shortcake and crackers) here.

>go to bedroom
Bedroom
 .   \_/       .:"    .:"    .:"
 -=(_)=- /\ ||    /\||    /\||
 .   / \     //\\|   //\\|   //\\|
 .          //  \\  //  \\  //  \\
 .         //    \ ^/    \^/    \\
 .         |  ( )  ||  ( ) || ( ) |
 .         |       ||      ||      |%
 &%&--==--&%-==--%&

You step into the bedroom and are flooded with emotion. Every inch of its surface now looks as if it's been dipped in. The walls are pulsating and warm, shifting from blue to red to violet. The scent of lilacs fill the air.  In the distance your kitchen fridge hums.

Lo-fi indie is playing from your computer. You notice movement on the screen. Beside you is a worn out drawer. To the left is a cramped closet.

>x computer
Your screen is being populated with a barrage of popups. The same message is written on them. "Your dreams await. \( ^^)/". 

The computer is currently switched on.

>click neopets
You enter neopets

>click
I didn't understand that sentence.

* * *

>click neopets
You enter neopets

>f
That's not a verb I recognise.

* * *

>w
Kitchen
Your kitchen has seen better days. A fridge lies in one corner. Near the door is a row of plants with yellowing leaves. At the north corner is a door that leads onto the street.

You can see a note and a fridge (closed) here.

>e
Bedroom
Your bedroom is unadorned. Nearby your kitchen light remains on.

Beside you is a worn out nightstand. You're not a fan of the washed out brown.

On the nightstand are a lamp and a book (closed).

Over in the corner your computer monitor blinks wearily. You must've forgotten to turn it off. 

On the computer is an USB.

An flyer lies wrinkled on the floor.

>open fridge
You can't see any such thing.

>w
Kitchen
Your kitchen has seen better days. A fridge lies in one corner. At the north corner is a door that leads onto the street.

The old fridge hums irratically. Your stomach growls.

>open fridge
Curiously, an apple is in the fridge.

>eat apple
(first taking the apple)
Something falls in your pocket.
Are ants coming out of the sink? No, probably no.

>e
Bedroom
Your bedroom is unadorned. Nearby your kitchen light remains on.

Beside you is a worn out nightstand. You're not a fan of the washed out brown.

On the nightstand are a lamp and a book (closed).

Over in the corner your computer monitor blinks wearily. You must've forgotten to turn it off. 

On the computer is an USB.

An flyer lies wrinkled on the floor.

>unlock book with key
You unlock the book.

>open book
Navigate to Page:

>yes
That was a rhetorical question.

>y
That was a rhetorical question.

I beg your pardon?

>yes
That was a rhetorical question.

I beg your pardon?

>g
That was a rhetorical question.

>dfg
That's not a verb I recognise.

>look around
You can't see any such thing.

>n
You can't go that way.

>n
You can't go that way.

>w
Kitchen
Your kitchen has seen better days. A fridge lies in one corner. At the north corner is a door that leads onto the street.

The old fridge hums irratically. Your stomach growls.

>e
Bedroom
Your bedroom is unadorned. Nearby your kitchen light remains on.

Beside you is a worn out nightstand. You're not a fan of the washed out brown.

On the nightstand are a lamp and a book (empty).

Over in the corner your computer monitor blinks wearily. You must've forgotten to turn it off. 

On the computer is an USB.

An flyer lies wrinkled on the floor.

>s
You can't go that way.

>s
You can't go that way.

>close book
You close the book.

>open book
Navigate to Page:

>1
That's not a verb I recognise.

>close book
You close the book.

>n
You can't go that way.

* * *

>w
Kitchen
Your kitchen has seen better days. A fridge lies in one corner. At the north corner is a door that leads onto the street.

The old fridge hums irratically. Your stomach growls.

>s
You can't go that way.

>close book
You can't see any such thing.

>open book
You can't see any such thing.

>1
That's not a verb I recognise.

>open book
You can't see any such thing.

>e
Bedroom
Your bedroom is unadorned. Nearby your kitchen light remains on.

Beside you is a worn out nightstand. You're not a fan of the washed out brown.

On the nightstand are a lamp and a book (closed).

Over in the corner your computer monitor blinks wearily. You must've forgotten to turn it off. 

On the computer is an USB.

An flyer lies wrinkled on the floor.

>take book
Taken.

>open book
Navigate to Page:

>Dreamland
*** Run-time problem P61: Attempt to move the player off-stage.

The room distorts around you.
That's not a verb I recognise.

* * *

>w
Kitchen
Your kitchen has seen better days. A fridge lies in one corner. Near the door is a row of plants with yellowing leaves. At the north corner is a door that leads onto the street.

You can see a note and a fridge (closed) here.

>eat apple
You can't see any such thing.

>open fridge
Curiously, an apple is in the fridge.

>eat apple
(first taking the apple)
Something falls in your pocket.

>i
You are carrying:
  a tiny steel key

Something falls in your pocket.

* * *

>w
Kitchen
Your kitchen has seen better days. A fridge lies in one corner. Near the door is a row of plants with yellowing leaves. At the north corner is a door that leads onto the street.

You can see a note and a fridge (closed) here.

>examine fridge
There's a note stuck to the fridge. It reads "Return USB to Fred. ."

>open fridge
You open the fridge, revealing an apple.

* * *

>eat apple
(first taking the apple)
You're dizzy.

>examine fridge
You're too disoriented
You're dizzy.

* * *

>w
Kitchen
Your kitchen has seen better days. A fridge lies in one corner. Near the door is a row of plants with yellowing leaves. At the north corner is a door that leads onto the street.

You can see a note and a fridge (closed) here.

>i
You are carrying nothing.

>open fridge
Curiously, an apple is in the fridge.

>eat apple
(first taking the apple)

>i
You are carrying:
  a tiny steel key

* * *

>w
Kitchen
Your kitchen has seen better days. A fridge lies in one corner. Near the door is a row of plants with yellowing leaves. At the north corner is a door that leads onto the street.

You can see a note and a fridge (closed) here.

>n
You put on a jacket.

Street

>n
Street2

>n
Street3

>n
Fred's House
Ruby smiles at you.

* * *

>w
Kitchen
Your kitchen has seen better days. A fridge lies in one corner. Near the door is a row of plants with yellowing leaves. At the north corner is a door that leads onto the street.

You can see a note and a fridge (closed) here.

>open frdige
You can't see any such thing.

>eat candy
You can't see any such thing.

>open fridge
The fridge contains ?????? ??? ?? ????? ??????? ??????? ?? ????
 and curiously, a piece of candy. The candy beckons to you.

* * *

>unlock drawer with key
You unlock the drawer.

>read journal
You can't see any such thing.

>take all
newsprint: Taken.

>open drawer
You pull open the drawer. A journal, a box of crayons, and a pair of glasses lies inside. The journal beckons to you.

>read journal
You're not reading anything.

>read journal
You're not reading anything.

>take journal
Taken.

>read journal
You flip the pages randomly and arrive at page 2:

A thunderous crack cuts through the air. Everything begins to spin. You watch as everything around you dissolves and reforms until your eyes begin to burn from the distortion. 2. "???????"

Toybox (Dreamland)
You open your eyes to pure whiteness. Every bit of empty space is blue lines, pink margins...

Margins! That's it. The world you're in is rendered on notebook paper. Objects are flat, paperlike, outlined in waxy lines. Trees sway, paper thin, a cluster of green scribbles. Nearby, red and blue scribbles hint at flowers. In the distance you spot a spiral shaped sun with pulsating lines. You look down at your hands and suppress a sharp cry. Your dress is a sloppy triangle, your body composed of black lines.

Everything is rendered crudely, as though by the hand of a child.

A girl no older than 5 is the creator of the flowers. She's sprawaled on the floor, scribbling away. She looks friendly.

>say fuck to emma
Emma covers her ears and turns red. "Stop it with the bad words or I'll tell Ms. Andringe!"

>tell emma fuck
I didn't understand that sentence.

>ask emma about fuck
Emma covers her ears and turns red. "Stop it with the bad words or I'll tell Ms. Andringe!"

>ask emma about ass
Emma covers her ears and turns red. "Stop it with the bad words or I'll tell Ms. Andringe!"

* * *

>open fridge
The fridge contains ?????? ??? ?? ????? ??????? ??????? ?? ????
 and curiously, a piece of candy. The candy beckons to you.

>e
Bedroom
Your bedroom is unadorned. Nearby your kitchen light remains on.

Over in the corner your computer monitor blinks wearily. You must've forgotten to turn it off.

An flyer lies wrinkled on the floor.

* * *

>open fridge
The fridge contains ?????? ??? ?? ????? ??????? ??????? ?? ????
 and curiously, a piece of candy. The candy beckons to you.

>eat apple
(first taking the apple)
A strange warmth washes over you. Things start to look funny. Something falls in your pocket.

I beg your pardon?

>x walls
You can't see any such thing.

* * *

>eat apple
(first taking the apple)
A strange warmth washes over you. Things start to look funny. Something falls in your pocket.

>e
Bedroom
You step into the bedroom and are flooded with emotion. Every inch of its surface now looks as if it's been dipped in iridescence. The walls are pulsating and warm, shifting from blue to red to violet.. In the distance your kitchen fridge hums.

Beside you is a worn out nightstand. It's covered with a thick layer of dust and lined with faint scratches.

Retro indie is playing from your computer. You notice movement on the screen.

A crumpled newsprint lies wrinkled on the floor.

You can also see Wall here.

>go to closet
Closet
It's empty except for a single cardbord box. You feel cramped.

You can see a cardboard box (closed) here.

* * *

>take all
cardboard box: Taken.
yearbook: Taken.
record player: Taken.
narwhal: Taken.

>i
You are carrying:
  narwhal
  record player
  a yearbook (open but empty)
  a cardboard box (open but empty)
  a tiny steel key

>x narwhal
An old hurt vibrates through you. You can't place why.

>x record player
Music sounds better on vinyl

Record player is currently switched off.

>switch record plauyer on
You can't see any such thing.

>switch record player on
You switch record player on.

Phoebe Bridgers fills the room.

>z
Time passes.

Twenty One Pilots fills the room.

* * *

>z
Time passes.

Fall Out Boy fills the room.

>switch record player off
You switch record player off.

>x nightstand
You can't see any such thing.

>x room
You can't see any such thing.

>x bedroom
You can't see any such thing.

>l
Closet
It's empty except for a single cardbord box. You feel cramped.

>go to bedroom
Bedroom
You step into the bedroom and are flooded with emotion. Every inch of its surface now looks as if it's been dipped in iridescence. The walls are pulsating and warm, shifting from blue to red to violet.. In the distance your kitchen fridge hums.

Beside you is a worn out nightstand. It's covered with a thick layer of dust and lined with faint scratches.

Retro indie is playing from your computer. You notice movement on the screen.

A crumpled newsprint lies wrinkled on the floor.

You can also see Wall here.

>l
Bedroom
You step into the bedroom and are flooded with emotion. Every inch of its surface now looks as if it's been dipped in iridescence. The walls are pulsating and warm, shifting from blue to red to violet.. In the distance your kitchen fridge hums.

Beside you is a worn out nightstand. It's covered with a thick layer of dust and lined with faint scratches.

Retro indie is playing from your computer. You notice movement on the screen.

A crumpled newsprint lies wrinkled on the floor.

You can also see Wall here.

>x nightstand
You see nothing special about the nightstand.

>take book
You can't see any such thing.

>i
You are carrying:
  narwhal
  record player
  a yearbook (open but empty)
  a cardboard box (open but empty)
  a tiny steel key

>open nightstand
You open the nightstand, revealing a book.

>take book
Taken.

>unlock book
What do you want to unlock the book with?

* * *

>l
Bedroom
You step into the bedroom and are flooded with emotion. Every inch of its surface now looks as if it's been dipped in iridescence. The walls are pulsating and warm, shifting from blue to red to violet.. In the distance your kitchen fridge hums.

Beside you is a worn out nightstand. It's covered with a thick layer of dust and lined with faint scratches.

Retro indie is playing from your computer. You notice movement on the screen.

A crumpled newsprint lies wrinkled on the floor.

You can also see Wall here.

>open book
You open the book.

>read page 1
What do you want to read page that in?

>read page 1 of book
Dreamland
You read: "a"

>go to bedroom
Bedroom
You step into the bedroom and are flooded with emotion. Every inch of its surface now looks as if it's been dipped in iridescence. The walls are pulsating and warm, shifting from blue to red to violet.. In the distance your kitchen fridge hums.

Beside you is a worn out nightstand. It's covered with a thick layer of dust and lined with faint scratches.

Retro indie is playing from your computer. You notice movement on the screen.

A crumpled newsprint lies wrinkled on the floor.

You can also see Wall here.

>play record player
> Select a song:

I beg your pardon?

> Select a song:

>4
Twice fills the room.
That's not a verb I recognise.

>3
That's not a verb I recognise.

>2
That's not a verb I recognise.

>1
That's not a verb I recognise.

>i
You are carrying:
  a book (open but empty)
  narwhal
  record player
  a yearbook (open but empty)
  a cardboard box (open but empty)
  a tiny steel key

>play record player
> Select a song:

>1
Phoebe Bridgers fills the room.
That's not a verb I recognise.

>i
You are carrying:
  a book (open but empty)
  narwhal
  record player
  a yearbook (open but empty)
  a cardboard box (open but empty)
  a tiny steel key

>x yearbook
Class of XXYZ.

>go to kitchen
Kitchen
Your kitchen has seen better days. A fridge lies in one corner. Near the door is a row of plants with yellowing leaves. At the north corner is a door that leads onto the street.

The fridge hums irratically. Your stomach growls.

>open fridge
That's already open.

>x fridge
There's a note stuck to the fridge. It reads  "Come play me in Dreamland /( ^^)/."

In the fridge are a black vial, a 'Drink Me' potion, shortcake and crackers.

>e
Bedroom
You step into the bedroom and are flooded with emotion. Every inch of its surface now looks as if it's been dipped in iridescence. The walls are pulsating and warm, shifting from blue to red to violet.. In the distance your kitchen fridge hums.

Beside you is a worn out nightstand. It's covered with a thick layer of dust and lined with faint scratches.

Retro indie is playing from your computer. You notice movement on the screen.

A crumpled newsprint lies wrinkled on the floor.

You can also see Wall here.

>x wall
The walls appear to be breathing.

>x newsprint
You straighten out the sheet of newspaper, handling it delicately.  The page contains two girls playing in a sandbox. The smaller of the two is labouring over a crudely formed sand sculpture. The other is occupied with making careful sand angels, her body covered in a layer of grime. You study the stature, the neat braids, the wrinkled clothing. They appear to be around preschool age. 

¯¯̿̿¯̿̿"̿̿̿̿̿̿̿"̿̿"̿̿̿̿̿"̿̿̿)͇̿̿)̿̿̿̿ "̿̿̿̿̿̿\̵͇̿̿\=(•̪̀●́)=o/̵͇̿̿/. You can't make out the caption.

>x flyer
You can't see any such thing.

* * *

>e
Bedroom
You step into the bedroom and are flooded with emotion. Every inch of its surface now looks as if it's been dipped in iridescence. The walls are pulsating and warm, shifting from blue to red to violet.. In the distance your kitchen fridge hums.

Beside you is a worn out nightstand. It's covered with a thick layer of dust and lined with faint scratches.

Retro indie is playing from your computer. You notice movement on the screen.

A crumpled newsprint lies wrinkled on the floor.

You can also see Wall here.

>take bok
You can't see any such thing.

>take book
Taken.

>unlock book with key
You unlock the book.

>open book
DreamlandNo
Over in the corner your computer monitor blinks wearily. You must've forgotten to turn it off. 

On the computer is an USB.

An flyer lies wrinkled on the floor.

* * *

>i
You are carrying:
  a tiny steel key

>e
Bedroom
Your bedroom is unadorned. Nearby your kitchen light remains on.

Beside you is a worn out nightstand.

On the nightstand are a lamp and a book (closed).

Over in the corner your computer monitor blinks wearily. You must've forgotten to turn it off. 

On the computer is an USB.

An flyer lies wrinkled on the floor.

>take book
Taken.

* * *

>i
You are carrying:
  a book (closed)
  a tiny steel key

>x book
 TABLE OF CONTENTS

 1  CULT LAND
 2  WHERE ARE YOU NOW?
 3  THIS IS NOW OR NEVER

>x book
 TABLE OF CONTENTS

 1  CULT LAND
 2  WHERE ARE YOU NOW?
 3  THIS IS NOW OR NEVER

>showme the contents of book
There seems to be no such object anywhere in the model world.

>showme the contents of Table of Book Contents
There seems to be no such object anywhere in the model world.

>showme the contents of Book Contents
There seems to be no such object anywhere in the model world.

* * *

>open book
Dreamland

* * *

>eat apple
(first taking the apple)
A strange warmth washes over you. Things start to look funny. Something falls in your pocket.

>t
That's not a verb I recognise.

>e
Bedroom
Your bedroom is unadorned. Nearby your kitchen light remains on.

Beside you is a worn out nightstand with an old lamp.

On the nightstand are a lamp and a book.

Over in the corner your computer monitor blinks wearily. You must've forgotten to turn it off.

An flyer lies wrinkled on the floor.

>w
Kitchen
Your kitchen has seen better days. A fridge lies in one corner.

The old fridge hums irratically. Your stomach growls.

Ruby smiles at you.

hello world

* * *

>eat apple
(first taking the apple)
A strange warmth washes over you. Things start to look funny. Something falls in your pocket.

>x
(the tiny steel key)
A stainless steel key, slightly bigger than your thumb.

>w
You can't go that way.

>e
Bedroom
Your bedroom is unadorned. Nearby your kitchen light remains on.

Beside you is a worn out nightstand.

On the nightstand are a lamp and a book (closed).

>take book
Taken.

>open book
It seems to be locked.

>unlock book with key
You unlock the book.

>x book
A worn out journal in which you've taken to scrawling your dreams.

>take dream book
You can't see any such thing.

>i
You are carrying:
  a book (closed)
  a tiny steel key

>read dream book
You can't see any such thing.

>read page 1
What do you want to read page that in?

>read page 1in dream book
You can't see any such thing.

>read page 1of dream book
You can't see any such thing.

>i
You are carrying:
  a book (closed)
  a tiny steel key

>open book
You open the book.

I beg your pardon?

>3
That's not a verb I recognise.

>1
That's not a verb I recognise.

>2
That's not a verb I recognise.

>3
That's not a verb I recognise.

* * *

>1
That's not a verb I recognise.

>i
You are carrying:
  a book (open but empty)
  a tiny steel key

>read book
You flip the pages randomly and arrive at page 4:

Dreamland
You read: "d"

>read page 2
What do you want to read page that in?

>read page 2 in book
Dreamland
You read: "b"

I beg your pardon?

>n
Dreamland 2
Over in the corner your computer monitor blinks wearily. You must've forgotten to turn it off. 

On the computer is an USB.

An flyer lies wrinkled on the floor.

>e
You can't go that way.

>s
Dreamland

>s
Kitchen
Your kitchen has seen better days. A fridge lies in one corner. At the north corner is a door that leads onto the street.

The old fridge hums irratically. Your stomach growls.

>i
You are carrying:
  a book (open but empty)
  a tiny steel key

>lock book with key
First you would have to close the book.

>close book
You close the book.

>close book
That's already closed.

>lock book with key
You lock the book.

>read book
You flip the pages randomly and arrive at page 1:

Dreamland
You read: "a"

The book is locked.

>book
That's not a verb I recognise.

>i
You are carrying:
  a book (closed and locked)
  a tiny steel key

>read book
You flip the pages randomly and arrive at page 2:

Dreamland
You read: "b"

The book is locked.

>unlock book with key
You unlock the book.

I beg your pardon?

>i
You are carrying:
  a book (closed)
  a tiny steel key

>read book
You flip the pages randomly and arrive at page 3:

Dreamland
You read: "c"

>read page 1 of book
Dreamland
You read: "a"

>read page 9203 of book
Page 9203 appears to be blank.

* * *

>eat apple
(first taking the apple)
A strange warmth washes over you. Things start to look funny. Something falls in your pocket.

>x fridge
There's a note stuck to the fridge. It reads "Return USB to Fred. . Fred is happy."

You're dizzy.

>x room
You can't see any such thing.

>x kitchen
You can't see any such thing.

>look at room
You can't see any such thing.

* * *

>open drawer
It seems to be locked.

* * *

>open drawer
You pull open the drawer. A journal, a box of crayons, and a pair of glasses lies inside. The journal beckons to you.

>take all
newsprint: Taken.
journal: Taken.
crayons: Taken.
glasses: Taken.

>drop lightbulb
The lightbulb is already here.

>open drawer
That's already open.

>read journal
You flip the pages randomly and arrive at page 4:

A thunderous crack cuts through the air. Everything begins to spin. You watch as everything around you dissolves and reforms until your eyes begin to burn from the distortion. 4. "???????"

Toybox (Dreamland)
You open your eyes to pure whiteness. Every bit of empty space is blue lines, pink margins...

Margins! That's it. The world you're in is rendered on notebook paper. Objects are flat, paperlike, outlined in waxy lines. Trees sway, paper thin, a cluster of green scribbles. Nearby, red and blue scribbles hint at flowers. In the distance you spot a spiral shaped sun with pulsating lines. You look down at your hands and suppress a sharp cry. Your dress is a sloppy triangle, your body composed of black lines.

Everything is rendered crudely, as though by the hand of a child.

A girl no older than 5 is the creator of the flowers. She's sprawaled on the floor, scribbling away. She looks friendly.

>say hi to emma
Emma crushes you in a hug. You found me!

>ask emma where you are
I didn't understand that sentence.

>ask emma
What do you want to ask Emma for?

>ask emma for help
You can't see any such thing.

>tell emma hi
I didn't understand that sentence.

>say hi to emma
Emma crushes you in a hug. You found me!

>say hello to emma
Emma doesn't seem to hear you. She seems lost in a daydream.

>say bye to emma
Emma doesn't seem to hear you. She seems lost in a daydream.

>ask emma about toybox
Emma doesn't seem to hear you. She seems lost in a daydream.

>tell hi to emma
You can't see any such thing.

>tell emma hi
I didn't understand that sentence.

>tell emma about hi
Emma doesn't seem to hear you. She seems lost in a daydream.

>say hi to girl
Emma crushes you in a hug. You found me!

>say hi to person
You can't see any such thing.

>say hi to woman
You can't see any such thing.

>say hi to human
You can't see any such thing.

>say hi to girl
Emma crushes you in a hug. You found me!

>say no to girl
Emma doesn't seem to hear you. She seems lost in a daydream.

* * *

>open fridge
The fridge contains ?????? ??? ?? ????? ??????? ??????? ?? ????
 and curiously, a piece of candy. The candy beckons to you.

>eay candy
That's not a verb I recognise.

>eat candy
(first taking the candy)
You pocket the candy. It feels heavy, like nostalgia.

You unwrap the candy and pop it in your mouth. It tastes of a strange medley of flavours - vanilla custard, citrus, a hint of buttered toast. Delightful.

A sudden prickling rips through your throat, like you've swallowed something you shouldn't have. You double over, coughing, clutching the counter for balance. There's something lodged in your throat.

Clang! Out comes a small piece of metal. You pick it up, bewildered. It's a small key.

* * *

>open drawer
It seems to be locked.

>open fridge
You can't see any such thing.

>unlock drawer with key
You unlock the drawer.

>open fridge
You can't see any such thing.

>open drawe
You can't see any such thing.

>open drawer
You pull open the drawer. A journal, a box of crayons, and a pair of glasses lies inside. The journal beckons to you.

* * *

>read journal
You flip the pages randomly and arrive at page 2:

A thunderous crack cuts through the air. Everything begins to spin. You watch as everything around you dissolves and reforms until your eyes begin to burn from the distortion. 2. "???????"

Toybox (Dreamland)
You open your eyes to pure whiteness. Every bit of empty space is blue lines, pink margins...

Margins! That's it. The world you're in is rendered on notebook paper. Objects are flat, paperlike, outlined in waxy lines. Trees sway, paper thin, a cluster of green scribbles. Nearby, red and blue scribbles hint at flowers. In the distance you spot a spiral shaped sun with pulsating lines. You look down at your hands and suppress a sharp cry. Your dress is a sloppy triangle, your body composed of black lines. Everything is rendered crudely, as though by the hand of a child.

A girl no older than five is playing in the meadow. She's crawling through the grass, plucking out a stem here and there.

You can also see a bunny and a clover here.

>say hi
(to Emma)
Emma crushes you in a hug. You found me!

>say hi to emma
Emma crushes you in a hug. You found me!

>ask emma where we are
I didn't understand that sentence.

>ask emma about where we are
Emma doesn't seem to hear you. She seems lost in a daydream.

>say hi
(to Emma)
Emma crushes you in a hug. You found me!

>say crayons
(to Emma)
Waahhhh! Crayons! Can I eat one?.

>kiss emma
Emma turns bright red. Whadya doing?

>hold emma’s hand
You can't see any such thing.

>hold hands with emma
You can't see any such thing.

>x emma
The girl is wearing a red checkered skirt. Her hair is in neat plaits.

>x girl
The girl is wearing a red checkered skirt. Her hair is in neat plaits.

>say hifd
(to Emma)
Emma doesn't seem to hear you. She seems lost in a daydream.

>say hi to Emma
Emma crushes you in a hug. You found me!

>say hiere to Emma
Emma doesn't seem to hear you. She seems lost in a daydream.

>say hiere to Emma
Emma doesn't seem to hear you. She seems lost in a daydream.

>ask emma about meadow
Emma looks solemn, "I'm looking for something. It's a special plant. My grandma told me it's got special powers, and I need it to make a wish.

>ask emma about wish
Huuuh? I can't tell you! "Cause if I did, it wouldn't come true!

>ask emma about hi
Emma crushes you in a hug. You found me!

>ask emma about art
C'mon! Let's draw together.

>ask emma about love
Emma is humming to herself.

>ask emma about shut
Emma is humming to herself.

>ask emma about shit
Emma covers her ears and turns red. "Stop it with the bad words or I'll tell Ms. Andringe!"

>ask emma about fuck
Emma covers her ears and turns red. "Stop it with the bad words or I'll tell Ms. Andringe!"

>i
You are carrying:
  glasses
  crayons
  a journal (closed)
  a newsprint
  a silver key

>draw with crayon
You can't see any such thing.

>draw
What do you want to draw?

>draw bunny
You doodle on the bunny Looks cute.

>draw glasses
You doodle on the glasses Looks cute.

>draw
What do you want to draw?

* * *

>draw bunny
You doodle on the bunny Looks cute.

>draw
What do you want to draw?

* * *

>draw bunny
You doodle on the bunny Looks cute.

>draw doodle
You can't see any such thing.

>draw bunny
You doodle on the bunny Looks cute.

>i
You are carrying:
  a bunny
  glasses
  crayons
  a journal (closed)
  a newsprint
  a silver key

>draw clover
You doodle on the clover Looks cute.

* * *

>open fridge
The fridge contains ?????? ??? ?? ????? ??????? ??????? ?? ????
 and curiously, a piece of candy. The candy beckons to you.

>i
You are carrying nothing.

>eat apple
(first taking the apple)
Something falls in your pocket.

>i
You are carrying:
  a tiny steel key

>i
You are carrying:
  a tiny steel key

>w
You can't go that way.

>e
Bedroom
Your bedroom is unadorned. Nearby your kitchen light remains on.

Beside you is a worn out nightstand. You're not a fan of the washed out brown.

On the nightstand are a lamp and a book (closed).

Over in the corner your computer monitor blinks wearily. You must've forgotten to turn it off. 

On the computer is an USB.

An flyer lies wrinkled on the floor.

* * *

>take book
Taken.

>use key on book
That's not a verb I recognise.

>unlock book with key
You unlock the book.

* * *

>open fridge
The fridge contains ?????? ??? ?? ????? ??????? ??????? ?? ????
 and curiously, a piece of candy. The candy beckons to you.

>take all
candy: Taken.

>eat candy
The sweetness spreads across your tongue and sends a tingle down your limbs. Things start to look funny. Colours shift, mutating back and forth. The acidity tickles your throat, and you choke, coughing aggressively into your hand. You expel a piece of metal from your throat. It's a small key.

>i
You are carrying:
  a silver key

>x key
A stainless steel key, slightly bigger than your thumb. It's wet with your saliva.

I beg your pardon?

>e
Bedroom
 .   \_/       .:"    .:"    .:"
 -=(_)=- /\||   /\||   /\||
 .    / \   //\\|   //\\| //\\|
 .          //  \\  //  \\ //  \\
 .         //    \ ^/    \^/    \\
 .         |  ( ). ||  ( ) ||    ( )
 .     &| | %    ||       ||       |%
 &%&--==--&%-==--%&

You step into the bedroom and are flooded with emotion. Every inch of its surface now looks as if it's been dipped in iridescence. The walls are pulsating and warm, shifting from blue to red to violet. The scent of lilacs fill the air.  In the distance your kitchen fridge hums.

Lo-fi indie is playing from your computer. You notice movement on the screen. Beside you is a worn out drawer. To the left is a cramped closet.

>x poster
You can't see any such thing.

* * *

>open fridge
The fridge contains ?????? ??? ?? ????? ??????? ??????? ?? ????
 and curiously, a piece of candy. The candy beckons to you.

>take apple
Taken.

>i
You are carrying:
  an apple

>eat apple
You're dizzy.

>t
That's not a verb I recognise.

>wait
Time passes.

You're dizzy.

>z
Time passes.

You're dizzy.

>z
Time passes.

You're dizzy.

* * *

>open fridge
The fridge contains ?????? ??? ?? ????? ??????? ??????? ?? ????
 and curiously, a piece of candy. The candy beckons to you.

>x candy
A lychee sweet. It glows mysteriously.

>take candy
You pocket the candy. It feels heavy, like nostalgia.

>eat candy
You unwrap the candy and pop it in your mouth. It tastes of a strange medley of flavours - custard, citrus, a hint of buttered toast. The sweetness spreads across your tongue. Delightful.

You feel a sudden seizing in your throat, like you've swallowed something you shouldn't have. You double over, coughing, clutching the counter for balance.

Clang! A small piece of metal hits the floor. You pick it up, bewildered. It's a small key.

* * *

>w
Kitchen
Your kitchen has seen better days. A fridge lies in one corner. Near the door is a row of plants with yellowing leaves. At the north corner is a door that leads onto the street.

You can see a note and a fridge (closed) here.

>w
You can't go that way.

>e
Bedroom
 .   \_/       .:"    .:"    .:"
 -=(_)=- /\ ||    /\||   /\||
 .   / \    //\\|   //\\|  //\\|
 .          //  \\  //  \\ //  \\
 .         //    \ ^/    \^/    \\
 .         |  ( ). ||  ( ) ||  ( ) |
 .       | |       ||      ||      |%
 &%&--==--&%-==--%&

Your bedroom is unadorned. The walls are chalky and the ground bare. The only decoration is a poster of The Killers. A lightbulb hangs from the ceiling. A tiny window is opened a crack, and the sound of faint static comes through. In the distance your kitchen fridge hums.

In the corner your monitor blinks wearily. You must've forgotten to turn it off. The low hum of the fan irks you. Beside you is a worn out drawer. To the left is a cramped closet.

>w
Kitchen
Your kitchen has seen better days. A fridge lies in one corner. Near the door is a row of plants with yellowing leaves. At the north corner is a door that leads onto the street.

You can see a note and a fridge (closed) here.

* * *

>take candy
You pocket the candy. It feels heavy, like nostalgia.

>x fridge
You're bizarrely attached to your fridge. It's charming in its age, rickedy, humming in a contented manner. It's covered with  and a note is pinned to it.

In the fridge are a black vial, a 'Drink Me' potion, shortcake and crackers.

>eat candy
You unwrap the candy and pop it in your mouth. It tastes of a strange medley of flavours - vanilla custard, citrus, a hint of buttered toast. Delightful.

A sudden prickling rips through your throat, like you've swallowed something you shouldn't have. You double over, coughing, clutching the counter for balance.

Clang! Out comes a small piece of metal. You pick it up, bewildered. It's a small key.

>w
You can't go that way.

>e
Bedroom
 .   \_/       .:"    .:"    .:"
 -=(_)=- /\ ||    /\||   /\||
 .   / \    //\\|   //\\|  //\\|
 .          //  \\  //  \\ //  \\
 .         //    \ ^/    \^/    \\
 .         |  ( ). ||  ( ) ||  ( ) |
 .       | |       ||      ||      |%
 &%&--==--&%-==--%&

You step into the bedroom and are flooded with emotion. Every inch of its surface now looks as if it's been dipped in iridescence. The walls are pulsating and warm, shifting from blue to red to violet. The scent of lilacs fill the air.  In the distance your kitchen fridge hums.

Lo-fi indie is playing from your computer. You notice movement on the screen. Beside you is a worn out drawer. To the left is a cramped closet.

* * *

>w
You can't go that way.

>n
You put on a jacket.

Street

>n
Bakery

>e
Fred's House
Fred greets you a firm hug, "About time, wheres my fucking usb"

>s
You put on a jacket.

Street

* * *

>w
Kitchen
Your kitchen has seen better days. A fridge lies in one corner. Near the door is a row of plants with yellowing leaves. At the north corner is a door that leads onto the street.

You can see a note and a fridge (closed) here.

>x e
You see nothing unexpected in that direction.

>e
Bedroom
You wake up in your bedroom.

Over in the corner your computer monitor blinks wearily. You must've forgotten to turn it off.

An flyer lies wrinkled on the floor.

>x w
You see nothing unexpected in that direction.

>x
What do you want to examine?

>x bedroom
You can't see any such thing.

>w
kitchen
Your kitchen has seen better days. A fridge lies in one corner.

The old fridge hums irratically.

>x fridge
In the fridge is an apple.

>open fridge
That's already open.

* * *

>w
Kitchen
Your kitchen has seen better days. A fridge lies in one corner. Near the door is a row of plants with yellowing leaves. At the north corner is a door that leads onto the street.

You can see a note and a fridge (closed) here.

>x fridge
There's a note stuck to the fridge. It reads "Return USB to Fred. ▒██░░░▓▓▓▓▓▓▓▓▓▓▓▒."

>open fridge
You open the fridge, revealing an apple.

* * *

>eat apple
(first taking the apple)
You're dizzy.

>x fridge
There's a note stuck to the fridge. It reads "Return USB to Fred"

You're dizzy.

>look
You're too disoriented
You're dizzy.

>look fridge
There's a note stuck to the fridge. It reads "Return USB to Fred"

You're dizzy.

>look at fridge
There's a note stuck to the fridge. It reads "Return USB to Fred"

You're dizzy.

* * *

>open fridge
You open the fridge, revealing an apple.

>x apple
You see nothing special about the apple.

>apple
That's not a verb I recognise.

>l
kitchen
Your kitchen has seen better days. A fridge lies in one corner.

The old fridge hums irratically.

>take apple
Taken.

>eat apple
You eat the apple. Not bad.

>e
Bedroom
You wake up in your bedroom.

Over in the corner your computer monitor blinks wearily. You must've forgotten to turn it off.

An flyer lies wrinkled on the floor.

>x flyer
The flyer displays an image of a man intertwined with a female robot. Distantly, you recall the cashier at CyberSpace handing it to you when you purchased your new speakers.

* * *

>w
Kitchen
Your kitchen has seen better days. A fridge lies in one corner. Near the door is a row of plants with yellowing leaves. At the north corner is a door that leads onto the street.

You can see a note and a fridge (closed) here.

>x note
You can't see any such thing.

* * *

>x
What do you want to examine?

>l
Computer
A worn out Windows XP with a jammed CD slot.

>x Computer
You can't see any such thing.

>x CD
You can't see any such thing.

* * *

>x
What do you want to examine?

>x room
You can't see any such thing.

* * *

>x bedroom
You can't see any such thing.

>look at bedroom
You can't see any such thing.

>x walls
You can't see any such thing.

>take all
newsprint: Taken.
ballpoint pen: Taken.

>open drawer
You pull open the drawer. A journal, a box of crayons, and a housekey lies inside.

>open nightstand
You can't see any such thing.

>x journal
You can't see any such thing.

>x book
A worn out journal in which you've taken to scrawling your dreams.

* * *

>open drawer
You pull open the drawer. A journal, a box of crayons, and a housekey lies inside.

>x journal
You can't see any such thing.

>take all
book: Taken.
crayons: Taken.
housekey: Taken.

>x journal
You can't see any such thing.

* * *

>x Bard
You can't see any such thing.

>z Barn
I only understood you as far as wanting to wait.

>x Barn
You can't see any such thing.

* * *

>x Example Location
You can't see any such thing.

>x room
You can't see any such thing.

* * *

>x Sutter
You can't see any such thing.

>L Sutter
You can't see any such thing.

>L
Sutter

>N
You can't go that way.

* * *

>x barn
You can't see any such thing.

>x Barn
You can't see any such thing.

* * *

>x bedroom
You can't see any such thing.

* * *

>x book
A worn out journal in which you've taken to scrawling your dreams.

>open book
It isn't something you can open.

* * *

>x book'
You can't see any such thing.

>x book
You see nothing special about the book.

* * *

>x computer
The computer is open to a game development software. You feel unsettled, like you're being watched. 

The computer is currently switched on.

>switch off computer
The monitor shuts off. The fan goes silent.

You switch the computer off.

>turn on computer
The monitor lights up with a staticky pop.

The computer is open to a game development software. You feel unsettled, like you're being watched. 

The computer is currently switched on.

>x computer
The computer is open to a game development software. You feel unsettled, like you're being watched. 

The computer is currently switched on.

>turn on computer
That's already on.

>switch off computer
The monitor shuts off. The fan goes silent.

You switch the computer off.

>x computer
A yellowing Windows XP that's seen better days. 

The computer is currently switched off.

>x poster
A relic of your emo era. The corners have frayed over the years.

>take poster
That's fixed in place.

>x window
North facing. Not a lot of light coming in.

>x newsprint
You straighten out the sheet of newspaper, handling it delicately. You can't quite make out the words. Your head is spinning.

* * *

>x computer
The computer is open to a game development software. You feel unsettled, like you're being watched. 

The computer is currently switched on.

>x computer
A yellowing Windows XP that's seen better days. 

On the computer is an USB.

>n
You can't go that way.

* * *

>w
Kitchen
Your kitchen has seen better days. A fridge lies in one corner. At the north corner is a door that leads onto the street.

The old fridge hums irratically. Your stomach growls.

>open fridge
You open the fridge, revealing an apple.

* * *

>eat apple
(first taking the apple)
You're dizzy.

>e
Bedroom
Your bedroom is unadorned. Nearby your kitchen light remains on.

Beside you is a worn out nightstand with an old lamp.

On the nightstand are a lamp and a book.

Over in the corner your computer monitor blinks wearily. You must've forgotten to turn it off. 

On the computer is an USB.

An flyer lies wrinkled on the floor.

>x computer
A yellowing Windows XP that's seen better days.  Fred's USB is plugged in. On your monitor, a folder of his family photos is displayed 

On the computer is an USB.

* * *

>x computer
The computer is open to a game development software. You feel unsettled, like you're being watched. 

The computer is currently switched on.

>x flyer
The flyer displays an image of a man intertwined with a female robot. Distantly, you recall the cashier at CyberSpace handing it to you when you purchased your new speakers.

>w
kitchen
Your kitchen has seen better days. A fridge lies in one corner.

* * *

>x drawer
You see nothing special about the drawer.

>open drawer
It seems to be locked.

* * *

>x emma
The girl is wearing a red checkered skirt. Her hair is in knotted and face streaked with mud. Her ankle is red and swelling.

>x mud
You can't see any such thing.

>x
(Emma)
The girl is wearing a red checkered skirt. Her hair is in knotted and face streaked with mud. Her ankle is red and swelling.

* * *

>x example location
You can't see any such thing.

* * *

>x flyer
The flyer displays an image of a man intertwined with a female robot. Distantly, you recall the cashier at CyberSpace handing it to you when you purchased your new speakers.

>x computer
A yellowing Windows XP that's seen better days.

>go to computer
You can't see any such thing.

>w
Kitchen
Your kitchen has seen better days. A fridge lies in one corner.

The old fridge hums irratically.

Ruby smiles at you.

>open fridge
You open the fridge, revealing an apple.

>take apple
Taken.

* * *

>eat apple
You eat the apple. Not bad.

>kill ruby
Violence isn't the answer to this one.

* * *

>x lightbulb
A single lightbulb. A string dangles.

The lightbulb is currently switched off.

>turn on
What do you want to turn on?

>turn on lightbulb
You pull on the lightbulb. Things seem a little brighter.

You switch the lightbulb on.

>w
Kitchen
Your kitchen has seen better days. A fridge lies in one corner. Near the door is a row of plants with yellowing leaves. At the north corner is a door that leads onto the street.

The fridge lies central to the kitchen. It's covered with an assortment of magnets and a note is pinned to it.

You can also see a note here.

>x note
There's a note stuck to the fridge. It reads  ¯¯̿̿¯̿̿"̿̿̿̿̿̿̿"̿̿"̿̿̿̿̿"̿̿̿)͇̿̿)̿̿̿̿ "̿̿̿̿̿̿\̵͇̿̿\=(•̪̀●́)=o/̵͇̿̿/"̿̿ ̿ ̿̿ ."

>take note
Taken.

>x fridge
You see nothing special about the fridge.

>open fridge
The fridge contains ?????? ??? ?? ????? ??????? ??????? ?? ????
 and curiously, an apple. The apple beckons to you.

* * *

>x monitor
You can't see any such thing.

>x desk
On the desk are a ballpoint pen and a computer.

* * *

>x newsprint
You straighten out the sheet of newspaper, handling it delicately. You can't quite make out the words. Your head is spinning.

>x desk
On the desk are a ballpoint pen and a computer.

>x computer
 

The computer is currently switched off.

>turn on computer
The monitor lights up.

You switch the computer on.

>take newsprint
Taken.

>x computer
A yellowing Windows XP that's seen better days. Last night's League of Legends match history stares you right in the face. 

The computer is currently switched on.

>x closet
hello room

>go to closet
Closet
It's empty except for a single cardbord box. You feel cramped.

You can see a cardboard box (closed) here.

>x cardboard box
You see nothing special about the cardboard box.

>open box
Inside is a yearbook, a record player, a binder, and a 3D printed narwhal, amongst other odds and ends.
The closet smells dusty.

* * *

>x yearbook
 ¯¯̿̿¯̿̿"̿̿̿̿̿̿̿"̿̿"̿̿̿̿̿"̿̿̿)͇̿̿)̿̿̿̿ "̿̿̿̿̿̿\̵͇̿̿\=(•̪̀●́)=o/̵͇̿̿/"̿̿ ̿ ̿̿ .

>x binder
That noun did not make sense in this context.

>x narwhal
An old hurt vibrates through you. You can't place why.

* * *

>x record player
Music sounds better on vinyl

Record player is currently switched off.

>go to record player
That noun did not make sense in this context.

>turn on record player
You switch record player on.

Phoebe Bridgers fills the room.

>look
Closet
It's empty except for a single cardbord box. You feel cramped.

You can see a cardboard box (in which are a yearbook (empty), record player and narwhal) here.

Fall Out Boy fills the room.

>go to room
That noun did not make sense in this context.

>go to bedroom
Bedroom
 \_/       .:"    .:"    .:"
 -=(_)=- /\||   /\||   /\||
 .    / \   //\\|  //\\| //\\|
 .          //  \\ //  \\ //  \\
 .         //    \^/    \^/    \\
 .          |  ( ).     ( )      ( )
 .     &|  | %   ||        |  ||  |%
 &%&--==--&%-==--%&

Your bedroom is unadorned. The walls are chalky and the ground bare. The only decoration is a poster of The Killers. A collection of empty plastic water bottles are scattered across the floor. A lightbulb hangs from the ceiling. A tiny window is opened a crack, and the sound of faint static comes through. In the distance your kitchen fridge hums.

Beside you is a worn out nightstand with a drawer. It's covered with a layer of dust and lined with faint scratches. To the left is a cramped closet.

Your computer monitor blinks wearily. You must've forgotten to turn it off. The low hum of the fan grates on you.

On the desk are a ballpoint pen and a computer.

>look
Bedroom
 \_/       .:"    .:"    .:"
 -=(_)=- /\||   /\||   /\||
 .    / \   //\\|  //\\| //\\|
 .          //  \\ //  \\ //  \\
 .         //    \^/    \^/    \\
 .          |  ( ).     ( )      ( )
 .     &|  | %   ||        |  ||  |%
 &%&--==--&%-==--%&

Your bedroom is unadorned. The walls are chalky and the ground bare. The only decoration is a poster of The Killers. A collection of empty plastic water bottles are scattered across the floor. A lightbulb hangs from the ceiling. A tiny window is opened a crack, and the sound of faint static comes through. In the distance your kitchen fridge hums.

Beside you is a worn out nightstand with a drawer. It's covered with a layer of dust and lined with faint scratches. To the left is a cramped closet.

Your computer monitor blinks wearily. You must've forgotten to turn it off. The low hum of the fan grates on you.

On the desk are a ballpoint pen and a computer.

>go to kitchen
Kitchen
Your kitchen has seen better days. A fridge lies in one corner. Near the door is a row of plants with yellowing leaves. At the north corner is a door that leads onto the street.

The fridge hums irratically. Your stomach growls.

>open fridge
The fridge contains ?????? ??? ?? ????? ??????? ??????? ?? ????
 and curiously, an apple. The apple beckons to you.

* * *

>eat apple
(first taking the apple)
A strange warmth washes over you. Things start to look funny. Something falls in your pocket.

>check pocket
That noun did not make sense in this context.

>i pocket
I only understood you as far as wanting to take inventory.

>i
You are carrying:
  a tiny steel key
  a newsprint

>open door
You can't see any such thing.

>go to door
That noun did not make sense in this context.

>go to bedroom
Bedroom
 \_/       .:"    .:"    .:"
 -=(_)=- /\||   /\||   /\||
 .    / \   //\\|  //\\| //\\|
 .          //  \\ //  \\ //  \\
 .         //    \^/    \^/    \\
 .          |  ( ).     ( )      ( )
 .     &|  | %   ||        |  ||  |%
 &%&--==--&%-==--%&

You step into the bedroom and are flooded with emotion. Every inch of its surface now looks as if it's been dipped in iridescence. The walls are pulsating and warm, shifting from blue to red to violet. The scent of lilacs fill the air.  In the distance your kitchen fridge hums.

Beside you is a worn out nightstand with a drawer. It's covered with a layer of dust and lined with faint scratches. To the left is a cramped closet.

Lo-fi indie is playing from your computer. You notice movement on the screen.

On the desk are a ballpoint pen and a computer.

>open nightstand
You can't see any such thing.

>open drawer
You pull open the drawer. A journal, a box of crayons, and a housekey lies inside.

>x journal
A worn out journal in which you've taken to scrawling your dreams.

>x crayons
A bright yellow box. On it are instructions on how to draw certain shapes: a bunny, a lion, a narwhal, and a unicorn.

>take crayons
Taken.

* * *

>take housekey
Taken.

>take journal
Taken.

>look room
That noun did not make sense in this context.

>look
Bedroom
 \_/       .:"    .:"    .:"
 -=(_)=- /\||   /\||   /\||
 .    / \   //\\|  //\\| //\\|
 .          //  \\ //  \\ //  \\
 .         //    \^/    \^/    \\
 .          |  ( ).     ( )      ( )
 .     &|  | %   ||        |  ||  |%
 &%&--==--&%-==--%&

You step into the bedroom and are flooded with emotion. Every inch of its surface now looks as if it's been dipped in iridescence. The walls are pulsating and warm, shifting from blue to red to violet. The scent of lilacs fill the air.  In the distance your kitchen fridge hums.

Beside you is a worn out nightstand with a drawer. It's covered with a layer of dust and lined with faint scratches. To the left is a cramped closet.

Lo-fi indie is playing from your computer. You notice movement on the screen.

On the desk are a ballpoint pen and a computer.

>x computer
Your screen is flooded with continuously spawning popups. The same message is written on them. "Your dreams await. \( ^^)/". 

The computer is currently switched on.

>i
You are carrying:
  a journal (closed and locked)
  a housekey
  crayons
  a tiny steel key
  a newsprint

>unlock journal
What do you want to unlock the journal with?

* * *

>unlock journal with key
That's unlocked at the moment.

>open journal
You open the journal.

>x journal
 TABLE OF CONTENTS
 1  TOYBOX
 2  ??????????
 3  ??????????

>1
That's not a verb I recognise.

>read page 1
What do you want to read page that in?

>journal
A thunderous crack cuts through the air. Everything begins to spin. The world begins to fragment. You watch as everything around you dissolves and reforms until your eyes begin to burn from the distortion. 1. "TOYBOX"

Toybox (Dreamland)
You open your eyes to a toy box. Everything around you looks as though it's been drawn with crayon. In front of you are a series of red and yellow scribbles that hint at flowers.

A girl no older than 5 is the creator of the flowers. She's sprawaled on the floor, scribbling away. She looks friendly.

>look
Toybox (Dreamland)
You open your eyes to a toy box. Everything around you looks as though it's been drawn with crayon. In front of you are a series of red and yellow scribbles that hint at flowers.

A girl no older than 5 is the creator of the flowers. She's sprawaled on the floor, scribbling away. She looks friendly.

>say hi to emma
There is no reply.

>turn off record player
You can't see any such thing.

>i
You are carrying:
  a journal (open but empty)
  a housekey
  crayons
  a tiny steel key
  a newsprint

>clear
What do you want to clear?

>clear screen
You can't see any such thing.

>emma
That's not a verb I recognise.

>x emma
You see nothing special about Emma.

>talk to girl
That's not a verb I recognise.

>say hi to girl
You can't see any such thing.

* * *

>x newsprint
You straighten out the sheet of newspaper, handling it delicately. You can't quite make out the words. Your head is spinning.

>x newsprint
You straighten out the sheet of newspaper, handling it delicately. You can't quite make out the words. Your head is spinning.

>x windiw
You can't see any such thing.

>x window
You can't see any such thing.

>x nightstand
You see nothing special about the nightstand.

>open drawer
What do you want to open drawer?

* * *

>open nightstand
You pull open the drawer. A book, a box of crayons, and a housekey lies inside.

>take all
newsprint: Taken.
book: Taken.
crayons: Taken.
housekey: Taken.

* * *

>draw
What do you want to draw?

* * *

>draw with crayons on wall
You can't see any such thing.

* * *

>i
You are carrying:
  a housekey
  crayons
  a book (closed and locked)
  a newsprint

* * *

>draw on computer
You can't see any such thing.

>draw computer
You doodle on computer.

>draw
What do you want to draw?

* * *

>x nightstand
You can't see any such thing.

>turn on lamp
It isn't something you can switch.

* * *

>x poster
Over the years the edges have frayed. A relic of your emo era.

>x lightbulb
A single lightbulb. A string dangles.

The lightbulb is currently switched off.

>turn on lightbulb
You pull on the lightbulb. Things seem a little brighter.

You switch the lightbulb on.

* * *

>x window
North facing. Not a lot of light coming in.

>pull light
It is fixed in place.

>turn light on
You pull on the lightbulb. Things seem a little brighter.

>x light
A single lightbulb. A string dangles.

The lightbulb is currently switched on.

>x computer
A yellowing Windows XP that's seen better days. 

The computer is currently switched off.

>turn on computer
The monitor lights up with a staticky pop.

I beg your pardon?

>x computer
The computer is open to a game development software. You feel unsettled, like you're being watched. 

The computer is currently switched on.

>x desk
On the desk are a ballpoint pen and a computer.

>look
Bedroom
 .   \_/       .:"    .:"    .:"
 -=(_)=- /\ ||    /\||    /\||
 .   / \     //\\|   //\\|   //\\|
 .          //  \\  //  \\  //  \\
 .         //    \ ^/    \^/    \\
 .         |  ( )  ||  ( ) || ( ) |
 .         |       ||      ||      |%
 &%&--==--&%-==--%&

Your bedroom is unadorned. The walls are chalky and the ground bare. The only decoration is a poster of The Killers. A lightbulb hangs from the ceiling. A tiny window is opened a crack, and the sound of faint static comes through.

In the corner your monitor blinks wearily. You must've forgotten to turn it off.  Beside you is a worn out drawer. To the north your kitchen fridge hums. To the south is a cramped closet.

>n
Kitchen
Your kitchen has seen better days. A fridge lies in one corner. Near the door is a row of plants with yellowing leaves.

You can see a jug, a plant, a note and a fridge (closed) here.

* * *

>open fridge
The fridge contains a jug and a piece of candy. The candy beckons to you.

>open candy
It isn't something you can open.

>eat candy
(first taking the candy)
You pocket the candy. It feels heavy, like nostalgia.

You unwrap the candy and pop it in your mouth. It tastes of a strange medley of flavours - vanilla custard, citrus, a hint of buttered toast. Delightful.

A sudden prickling rips through your throat, like you've swallowed something you shouldn't have. You double over, coughing, clutching the counter for balance. There's something lodged in your throat.

Clang! Out comes a small piece of metal. You pick it up, bewildered. It's a small key.

You can press i to view your inventory.

* * *

>i
You are carrying:
  a silver key

I beg your pardon?

>k
That's not a verb I recognise.

>kill
(the silver key)
Violence isn't the answer to this one.

>eat
(the silver key)
That's plainly inedible.

>take al
You can't see any such thing.

>take all
jug: Taken. Filled with water.

>x plant
It looks parched.

>water plant
You water the plant with the jug. The plant perks up a little.

>drop jug
Dropped.

>water plant
You don't have anything to water it with.

>n
You can't go that way.

* * *

>x computer
Your screen is being populated with a barrage of popups. The same message is written on them. "Your dreams await. \( ^^)/". 

The computer is currently switched on.

>unlock drawer with key
The drawer yawns open lazily. In it are a journal, crayons and glasses

* * *

>y
That was a rhetorical question.

The shadows are growing darker.